Time,Team,Operation,BuyVolume,SellVolume,EtfPosition,FuturePosition,EtfPrice,FuturePrice,TotalFees,AccountBalance,ProfitOrLoss,Status
0.0,TraderOne,Tick,0,0,0,0,,,0,0,0,OK
0.234,TraderOne,Tick,0,0,0,0,,,0,0,0,OK
0.5,TraderOne,Tick,0,0,0,0,,,0,0,0,OK
0.781,TraderOne,Tick,0,0,0,0,,,0,0,0,OK
1.047,TraderOne,Tick,0,10,-10,10,147600,147100,-147,147,-1853,OK
1.25,TraderOne,Tick,1,10,-9,9,147000,147100,-118,218,1118,OK
1.469,TraderOne,Tick,1,10,-9,9,147000,147100,-118,218,1118,OK
1.734,TraderOne,Tick,1,10,-9,9,147000,147100,-118,218,1118,OK
2.047,TraderOne,Tick,1,10,-9,9,147000,147100,-118,218,1118,OK
2.297,TraderOne,Tick,1,10,-9,9,147000,146900,-118,218,-682,OK
2.547,TraderOne,Tick,11,10,1,-1,146400,146900,-265,-2635,-2835,OK
2.75,TraderOne,Tick,11,10,1,-1,146400,146900,-265,-2635,-2835,OK
3.0,TraderOne,Tick,11,10,1,-1,146400,146900,-265,-2635,-2835,OK
3.281,TraderOne,Tick,11,10,1,-1,146400,146900,-265,-2635,-2835,OK
3.5,TraderOne,Tick,11,20,-9,9,147500,146900,-412,-2488,-4288,OK
3.781,TraderOne,Tick,21,20,1,-1,146300,146900,-559,-3341,-3541,OK
4.016,TraderOne,Tick,21,20,1,-1,146300,146900,-559,-3341,-3541,OK
4.25,TraderOne,Tick,21,20,1,-1,146300,146900,-559,-3341,-3541,OK
4.469,TraderOne,Tick,21,20,1,-1,146300,146900,-559,-3341,-3541,OK
4.797,TraderOne,Tick,31,20,11,-11,146300,146900,-706,-3194,-5394,OK
4.969,TraderOne,Tick,31,20,11,-11,146300,146900,-706,-3194,-5394,OK
5.281,TraderOne,Tick,31,20,11,-11,146300,146800,-706,-3194,-5394,OK
5.484,TraderOne,Tick,31,20,11,-11,146300,146800,-706,-3194,-5394,OK
5.797,TraderOne,Tick,31,20,11,-11,146300,146800,-706,-3194,-5394,OK
6.0,TraderOne,Tick,31,30,1,-1,147000,146800,-412,-3488,-3288,OK
6.25,TraderOne,Tick,31,40,-9,9,147000,146800,-118,-2782,-4582,OK
6.469,TraderOne,Tick,31,50,-19,19,147000,146800,176,-76,-3876,OK
6.797,TraderOne,Tick,31,60,-29,29,147200,146700,470,2630,-3170,OK
7.031,TraderOne,Tick,31,60,-29,29,147200,146900,470,2630,-3170,OK
7.234,TraderOne,Tick,31,60,-29,29,147200,146900,470,2630,-3170,OK
7.469,TraderOne,Tick,31,60,-29,29,147200,146900,470,2630,-3170,OK
7.75,TraderOne,Tick,31,60,-29,29,147200,146900,470,2630,-3170,OK
8.031,TraderOne,Tick,31,60,-29,29,147200,146900,470,2630,-3170,OK
8.266,TraderOne,Tick,41,60,-19,19,147000,146900,323,-223,-2123,OK
8.5,TraderOne,Tick,41,60,-19,19,147000,146900,323,-223,-2123,OK
8.781,TraderOne,Tick,41,60,-19,19,147000,146900,323,-223,-2123,OK
8.969,TraderOne,Tick,51,60,-9,9,146700,146900,176,-2076,-276,OK
9.219,TraderOne,Tick,61,60,1,-1,146400,146900,469,631,431,OK
9.453,TraderOne,Tick,71,60,11,-11,146400,146900,762,2338,138,OK
9.703,TraderOne,Tick,81,60,21,-21,146400,146900,1055,4045,-155,OK
10.0,TraderOne,Tick,81,60,21,-21,146400,146900,1055,4045,-155,OK
10.281,TraderOne,Tick,91,60,31,-31,146400,146900,1348,5752,-448,OK
10.547,TraderOne,Tick,101,60,41,-41,146400,146900,1641,9459,1259,OK
10.75,TraderOne,Tick,111,60,51,-51,146400,147000,1934,14166,3966,OK
10.953,TraderOne,Tick,111,70,41,-41,147300,147000,1787,9313,17513,OK
11.281,TraderOne,Tick,111,70,41,-41,147300,147000,1787,9313,17513,OK
11.547,TraderOne,Tick,111,70,41,-41,147300,147000,1787,9313,17513,OK
11.766,TraderOne,Tick,111,80,31,-41,147400,147200,1640,1477460,11660,OK
12.063,TraderOne,Tick,111,80,31,-31,147400,147200,1640,6460,12660,OK
12.297,TraderOne,Tick,111,80,31,-31,147400,147200,1640,6460,12660,OK
12.484,TraderOne,Tick,111,80,31,-31,147400,147200,1640,6460,12660,OK
12.813,TraderOne,Tick,111,80,31,-31,147400,147200,1640,6460,12660,OK
13.016,TraderOne,Tick,111,80,31,-31,147400,147200,1640,6460,12660,OK
13.219,TraderOne,Tick,111,80,31,-31,146600,147200,1640,6460,260,OK
13.484,TraderOne,Tick,111,80,31,-31,146600,147200,1640,6460,260,OK
13.797,TraderOne,Tick,111,80,31,-31,146600,147200,1640,6460,260,OK
14.047,TraderOne,Tick,111,80,31,-31,146600,147200,1640,6460,260,OK
14.266,TraderOne,Tick,111,80,31,-31,146600,147200,1640,6460,260,OK
14.5,TraderOne,Tick,111,80,31,-31,146600,147200,1640,6460,260,OK
14.75,TraderOne,Tick,111,80,31,-31,146600,147200,1640,6460,260,OK
14.969,TraderOne,Tick,111,80,31,-31,146600,147200,1640,6460,260,OK
15.25,TraderOne,Tick,111,80,31,-31,146600,147200,1640,6460,260,OK
15.453,TraderOne,Tick,111,90,21,-21,146900,147200,1493,3607,-593,OK
15.797,TraderOne,Tick,111,90,21,-21,146900,146800,1493,3607,5707,OK
16.0,TraderOne,Tick,111,100,11,-11,146900,146900,1346,754,754,OK
16.297,TraderOne,Tick,111,100,11,-11,146900,146900,1346,754,754,OK
16.5,TraderOne,Tick,111,100,11,-11,146900,146900,1346,754,754,OK
16.781,TraderOne,Tick,111,100,11,-11,146900,146900,1346,754,754,OK
17.063,TraderOne,Tick,111,100,11,-11,146900,146900,1346,754,754,OK
17.234,TraderOne,Tick,111,100,11,-11,146900,146900,1346,754,754,OK
17.547,TraderOne,Tick,111,100,11,-11,146900,146900,1346,754,754,OK
17.828,TraderOne,Tick,121,100,21,-21,146900,146900,1640,1460,1460,OK
17.984,TraderOne,Tick,121,100,21,-21,146900,146900,1640,1460,1460,OK
18.297,TraderOne,Tick,131,100,31,-31,146600,146900,1493,4607,-1593,OK
18.469,TraderOne,Tick,131,100,31,-31,146600,147100,1493,4607,-1593,OK
18.734,TraderOne,Tick,131,100,31,-31,146600,147100,1493,4607,-1593,OK
19.047,TraderOne,Tick,131,100,31,-31,146600,147100,1493,4607,-1593,OK
19.234,TraderOne,Tick,131,100,31,-31,146600,147100,1493,4607,-1593,OK
19.516,TraderOne,Tick,131,100,31,-31,146600,147200,1493,4607,-1593,OK
19.781,TraderOne,Tick,131,100,31,-31,146600,147200,1493,4607,-1593,OK
20.0,TraderOne,Tick,131,100,31,-31,146600,147200,1493,4607,-1593,OK
20.281,TraderOne,Tick,141,100,41,-41,146900,147200,1787,7313,-887,OK
20.531,TraderOne,Tick,151,100,51,-51,146900,147900,2081,12019,1819,OK
20.766,TraderOne,Tick,161,110,51,-61,147500,147900,2228,1493872,4672,OK
21.047,TraderOne,Tick,161,116,45,-45,147600,147900,2405,12895,3895,OK
21.219,TraderOne,Tick,161,116,45,-45,147600,147900,2405,12895,3895,OK
21.5,TraderOne,Tick,161,116,45,-45,147600,147900,2405,12895,3895,OK
21.766,TraderOne,Tick,161,116,45,-45,147600,147900,2405,12895,3895,OK
22.0,TraderOne,Tick,161,116,45,-45,147600,148000,2405,12895,3895,OK
22.25,TraderOne,Tick,161,116,45,-45,147600,148000,2405,12895,3895,OK
22.563,TraderOne,Tick,161,116,45,-45,147600,148100,2405,12895,3895,OK
22.781,TraderOne,Tick,161,116,45,-45,147600,148100,2405,12895,3895,OK
22.953,TraderOne,Tick,161,116,45,-45,147600,148000,2405,12895,3895,OK
23.25,TraderOne,Tick,161,116,45,-45,147600,148000,2405,12895,3895,OK
23.5,TraderOne,Tick,161,126,35,-35,147400,147700,2700,9600,2600,OK
23.703,TraderOne,Tick,161,126,35,-35,147400,147700,2700,9600,2600,OK
23.984,TraderOne,Tick,161,126,35,-35,147400,147700,2700,9600,2600,OK
24.203,TraderOne,Tick,171,126,45,-45,147400,147700,2995,12305,3305,OK
24.453,TraderOne,Tick,171,126,45,-45,147400,147700,2995,12305,3305,OK
24.703,TraderOne,Tick,181,126,55,-55,147400,147700,3290,16010,5010,OK
25.047,TraderOne,Tick,181,126,55,-55,147400,148100,3290,16010,5010,OK
25.188,TraderOne,Tick,191,126,65,-65,147700,148200,3585,20715,7715,OK
25.547,TraderOne,Tick,191,136,55,-55,147700,147900,3880,14420,3420,OK
25.719,TraderOne,Tick,191,143,48,-48,147600,147900,3777,11023,1423,OK
26.031,TraderOne,Tick,191,143,48,-48,147600,147900,3777,11023,1423,OK
26.203,TraderOne,Tick,191,143,48,-48,147600,147900,3777,11023,1423,OK
26.469,TraderOne,Tick,191,143,48,-48,147400,147900,3777,11023,1423,OK
26.703,TraderOne,Tick,191,143,48,-48,147400,147900,3777,11023,1423,OK
27.016,TraderOne,Tick,191,143,48,-48,147400,147900,3777,11023,1423,OK
27.219,TraderOne,Tick,201,143,58,-58,147400,147900,3629,15171,3571,OK
27.5,TraderOne,Tick,201,143,58,-58,147400,147900,3629,15171,3571,OK
27.797,TraderOne,Tick,201,143,58,-58,147400,147800,3629,15171,3571,OK
27.969,TraderOne,Tick,211,153,58,-58,147200,147800,3334,16466,4866,OK
28.234,TraderOne,Tick,211,153,58,-58,147200,147800,3334,16466,4866,OK
28.5,TraderOne,Tick,211,163,48,-48,147700,147800,3187,11613,6813,OK
28.734,TraderOne,Tick,211,163,48,-48,147700,147600,3187,11613,16413,OK
28.969,TraderOne,Tick,211,163,48,-48,147700,147600,3187,11613,16413,OK
29.219,TraderOne,Tick,211,163,48,-48,147700,147600,3187,11613,16413,OK
29.5,TraderOne,Tick,211,163,48,-48,147700,147600,3187,11613,16413,OK
29.781,TraderOne,Tick,211,163,48,-48,147700,147600,3187,11613,16413,OK
30.063,TraderOne,Tick,211,173,38,-38,147700,147600,3040,7760,11560,OK
30.219,TraderOne,Tick,211,173,38,-38,147700,147600,3040,7760,11560,OK
30.516,TraderOne,Tick,211,173,38,-38,147700,147600,3040,7760,11560,OK
30.797,TraderOne,Tick,211,173,38,-38,147700,147400,3040,7760,15360,OK
31.016,TraderOne,Tick,221,173,48,-48,147000,147400,3334,10466,866,OK
31.203,TraderOne,Tick,231,173,58,-58,147000,147400,3628,14172,2572,OK
31.469,TraderOne,Tick,241,173,68,-68,147000,147400,3922,18878,5278,OK
31.766,TraderOne,Tick,241,173,68,-68,147000,147400,3922,18878,5278,OK
31.984,TraderOne,Tick,241,173,68,-68,147000,147400,3922,18878,5278,OK
32.25,TraderOne,Tick,241,173,68,-68,147000,147400,3922,18878,5278,OK
32.484,TraderOne,Tick,241,183,58,-58,147100,147400,4216,12584,984,OK
32.797,TraderOne,Tick,241,183,58,-58,147100,147600,4216,12584,984,OK
32.969,TraderOne,Tick,241,193,48,-48,147000,147600,4510,7290,-2310,OK
33.234,TraderOne,Tick,241,193,48,-48,147000,147600,4510,7290,-2310,OK
33.5,TraderOne,Tick,241,193,48,-48,147000,147600,4510,7290,-2310,OK
33.781,TraderOne,Tick,241,203,38,-38,146900,147600,4804,2996,-4604,OK
34.0,TraderOne,Tick,241,203,38,-38,146900,147600,4804,2996,-4604,OK
34.25,TraderOne,Tick,241,203,38,-38,146900,147200,4804,2996,-4604,OK
34.453,TraderOne,Tick,241,203,38,-38,146900,147200,4804,2996,-4604,OK
34.688,TraderOne,Tick,241,203,38,-38,146900,147200,4804,2996,-4604,OK
35.047,TraderOne,Tick,241,203,38,-38,146900,147200,4804,2996,-4604,OK
35.281,TraderOne,Tick,241,203,38,-38,146900,147300,4804,2996,-4604,OK
35.563,TraderOne,Tick,241,213,28,-28,147100,147000,4657,-1857,943,OK
35.781,TraderOne,Tick,241,223,18,-18,147200,147000,4951,-4151,-551,OK
35.984,TraderOne,Tick,241,223,18,-18,147200,147000,4951,-4151,-551,OK
36.219,TraderOne,Tick,241,223,18,-18,147200,147000,4951,-4151,-551,OK
36.484,TraderOne,Tick,241,230,11,-11,147200,147000,5157,-5057,-2857,OK
36.797,TraderOne,Tick,241,230,11,-11,147200,147000,5157,-5057,-2857,OK
36.953,TraderOne,Tick,241,230,11,-11,147200,147000,5157,-5057,-2857,OK
37.297,TraderOne,Tick,241,230,11,-11,147200,147000,5157,-5057,-2857,OK
37.453,TraderOne,Tick,241,230,11,-11,147200,147300,5157,-5057,-6157,OK
37.75,TraderOne,Tick,241,230,11,-11,147200,147300,5157,-5057,-6157,OK
38.047,TraderOne,Tick,241,230,11,-11,147200,147300,5157,-5057,-6157,OK
38.219,TraderOne,Tick,241,230,11,-11,147200,147300,5157,-5057,-6157,OK
38.453,TraderOne,Tick,241,230,11,-11,147200,147300,5157,-5057,-6157,OK
38.797,TraderOne,Tick,241,230,11,-11,147200,147300,5157,-5057,-6157,OK
38.953,TraderOne,Tick,241,230,11,-11,147200,147300,5157,-5057,-6157,OK
39.25,TraderOne,Tick,251,230,21,-21,147000,147300,5010,-3910,-8110,OK
39.547,TraderOne,Tick,251,240,11,-11,147700,147300,4863,-5763,-3563,OK
39.703,TraderOne,Tick,251,240,11,-11,147700,147300,4863,-5763,-3563,OK
40.031,TraderOne,Tick,251,240,11,-11,147700,147300,4863,-5763,-3563,OK
40.266,TraderOne,Tick,251,240,11,-11,147700,147300,4863,-5763,-3563,OK
40.531,TraderOne,Tick,251,250,1,-1,147700,147300,4716,-5616,-5416,OK
40.766,TraderOne,Tick,251,250,1,-1,147700,147300,4716,-5616,-5416,OK
41.016,TraderOne,Tick,251,250,1,-1,147700,147300,4716,-5616,-5416,OK
41.203,TraderOne,Tick,251,250,1,-1,147700,147300,4716,-5616,-5416,OK
41.5,TraderOne,Tick,251,250,1,-1,147700,147300,4716,-5616,-5416,OK
41.734,TraderOne,Tick,251,250,1,-1,147700,147300,4716,-5616,-5416,OK
42.031,TraderOne,Tick,251,250,1,-1,147700,147200,4716,-5616,-5416,OK
42.297,TraderOne,Tick,251,258,-7,7,147400,147200,4598,-5498,-6898,OK
42.563,TraderOne,Tick,251,258,-7,7,147400,147200,4598,-5498,-6898,OK
42.766,TraderOne,Tick,251,258,-7,7,147400,147200,4598,-5498,-6898,OK
43.047,TraderOne,Tick,251,258,-7,7,147400,147200,4598,-5498,-6898,OK
43.266,TraderOne,Tick,251,258,-7,7,147400,147200,4598,-5498,-6898,OK
43.484,TraderOne,Tick,251,258,-7,7,147400,147200,4598,-5498,-6898,OK
43.75,TraderOne,Tick,251,258,-7,7,147400,147400,4598,-5498,-5498,OK
44.0,TraderOne,Tick,251,258,-7,7,147400,147400,4598,-5498,-5498,OK
44.203,TraderOne,Tick,251,258,-7,7,147400,147400,4598,-5498,-5498,OK
44.547,TraderOne,Tick,251,258,-7,7,147400,147400,4598,-5498,-5498,OK
44.734,TraderOne,Tick,251,258,-7,7,147400,147400,4598,-5498,-5498,OK
44.969,TraderOne,Tick,251,258,-7,7,147700,147400,4598,-5498,-6898,OK
45.297,TraderOne,Tick,251,258,-7,7,147700,147500,4598,-5498,-6898,OK
45.516,TraderOne,Tick,251,258,-7,7,147700,147500,4598,-5498,-6898,OK
45.734,TraderOne,Tick,251,268,-17,17,147400,147500,4893,-5793,-4093,OK
46.016,TraderOne,Tick,251,268,-17,17,147400,147500,4893,-5793,-4093,OK
46.266,TraderOne,Tick,251,268,-17,17,147400,147500,4893,-5793,-4093,OK
46.469,TraderOne,Tick,251,268,-17,17,147400,147500,4893,-5793,-4093,OK
46.797,TraderOne,Tick,251,268,-17,17,147400,147500,4893,-5793,-4093,OK
47.031,TraderOne,Tick,251,276,-25,25,147400,147500,5129,-4429,-1929,OK
47.266,TraderOne,Tick,251,276,-25,25,147400,147500,5129,-4429,-1929,OK
47.469,TraderOne,Tick,251,276,-25,25,147400,147500,5129,-4429,-1929,OK
47.797,TraderOne,Tick,251,286,-35,35,147700,147500,4981,-2281,-9281,OK
48.016,TraderOne,Tick,251,286,-35,35,147700,147500,4981,-2281,-9281,OK
48.25,TraderOne,Tick,251,286,-35,35,147700,147500,4981,-2281,-9281,OK
48.547,TraderOne,Tick,261,286,-25,25,147100,147500,4833,-7133,-2133,OK
48.813,TraderOne,Tick,261,286,-25,25,147100,147500,4833,-7133,-2133,OK
49.0,TraderOne,Tick,261,286,-25,25,147100,147500,4833,-7133,-2133,OK
49.219,TraderOne,Tick,261,286,-25,25,147100,147500,4833,-7133,-2133,OK
49.453,TraderOne,Tick,271,286,-15,15,147700,147500,5128,-10428,-13428,OK
49.75,TraderOne,Tick,271,286,-15,15,147700,147500,5128,-10428,-13428,OK
50.0,TraderOne,Tick,271,286,-15,15,147700,147500,5128,-10428,-13428,OK
50.25,TraderOne,Tick,271,286,-15,15,147700,147500,5128,-10428,-13428,OK
50.5,TraderOne,Tick,271,286,-15,15,147700,147500,5128,-10428,-13428,OK
50.781,TraderOne,Tick,271,286,-15,15,147700,147500,5128,-10428,-13428,OK
51.031,TraderOne,Tick,271,286,-15,15,147700,147500,5128,-10428,-13428,OK
51.281,TraderOne,Tick,271,286,-15,15,147700,147500,5128,-10428,-13428,OK
51.453,TraderOne,Tick,271,286,-15,15,147700,147500,5128,-10428,-13428,OK
51.734,TraderOne,Tick,271,286,-15,15,147700,147500,5128,-10428,-13428,OK
51.984,TraderOne,Tick,271,286,-15,15,147700,147300,5128,-10428,-13428,OK
52.203,TraderOne,Tick,271,286,-15,15,147700,147300,5128,-10428,-13428,OK
52.453,TraderOne,Tick,271,286,-15,15,147700,147300,5128,-10428,-13428,OK
52.781,TraderOne,Tick,271,286,-15,15,147700,147300,5128,-10428,-13428,OK
53.047,TraderOne,Tick,271,286,-15,15,147700,147300,5128,-10428,-13428,OK
53.25,TraderOne,Tick,271,286,-15,15,147700,147300,5128,-10428,-13428,OK
53.547,TraderOne,Tick,271,286,-15,15,147700,147300,5128,-10428,-13428,OK
53.75,TraderOne,Tick,271,286,-15,15,147700,147300,5128,-10428,-13428,OK
54.031,TraderOne,Tick,271,286,-15,15,147700,147300,5128,-10428,-13428,OK
54.234,TraderOne,Tick,271,286,-15,15,147700,147300,5128,-10428,-13428,OK
54.516,TraderOne,Tick,271,286,-15,15,147700,147200,5128,-10428,-13428,OK
54.781,TraderOne,Tick,271,286,-15,15,147700,147200,5128,-10428,-13428,OK
55.031,TraderOne,Tick,271,286,-15,15,147700,147200,5128,-10428,-13428,OK
55.266,TraderOne,Tick,271,286,-15,15,147300,147300,5128,-10428,-10428,OK
55.578,TraderOne,Tick,281,286,-5,15,147300,146900,4981,-1484281,-16281,OK
55.75,TraderOne,Tick,281,296,-15,15,147100,146900,5276,-13576,-16576,OK
55.953,TraderOne,Tick,281,296,-15,15,147100,146900,5276,-13576,-16576,OK
56.234,TraderOne,Tick,281,296,-15,15,147100,147100,5276,-13576,-13576,OK
56.469,TraderOne,Tick,281,296,-15,15,147100,147100,5276,-13576,-13576,OK
56.75,TraderOne,Tick,281,296,-15,15,147100,147100,5276,-13576,-13576,OK
57.016,TraderOne,Tick,281,296,-15,15,147100,147100,5276,-13576,-13576,OK
57.25,TraderOne,Tick,281,306,-25,25,147100,147100,5570,-11870,-11870,OK
57.469,TraderOne,Tick,281,306,-25,25,147100,146800,5570,-11870,-16870,OK
57.797,TraderOne,Tick,281,316,-35,35,147000,146600,5865,-8565,-15565,OK
58.016,TraderOne,Tick,281,316,-35,35,147000,146600,5865,-8565,-15565,OK
58.234,TraderOne,Tick,281,316,-35,35,147000,146600,5865,-8565,-15565,OK
58.5,TraderOne,Tick,281,316,-35,35,147000,146700,5865,-8565,-15565,OK
58.797,TraderOne,Tick,281,316,-35,35,147000,146700,5865,-8565,-15565,OK
58.938,TraderOne,Tick,281,316,-35,35,147000,146700,5865,-8565,-15565,OK
59.234,TraderOne,Tick,281,316,-35,35,147000,146700,5865,-8565,-15565,OK
59.531,TraderOne,Tick,281,326,-45,45,147000,146500,6159,-4859,-13859,OK
59.734,TraderOne,Tick,281,326,-45,45,147000,146500,6159,-4859,-13859,OK
59.984,TraderOne,Tick,281,326,-45,45,147000,146500,6159,-4859,-13859,OK
60.281,TraderOne,Tick,281,326,-45,45,147000,146700,6159,-4859,-13859,OK
60.547,TraderOne,Tick,291,326,-35,35,147200,146700,6453,-10153,-17153,OK
60.781,TraderOne,Tick,291,326,-35,35,147200,146600,6453,-10153,-17153,OK
60.984,TraderOne,Tick,291,329,-38,38,147000,146500,6541,-9341,-16941,OK
61.219,TraderOne,Tick,291,329,-38,38,147000,146500,6541,-9341,-16941,OK
61.5,TraderOne,Tick,291,329,-38,38,147000,146500,6541,-9341,-16941,OK
61.734,TraderOne,Tick,291,329,-38,38,147000,146500,6541,-9341,-16941,OK
62.0,TraderOne,Tick,291,329,-38,38,147000,146500,6541,-9341,-16941,OK
62.266,TraderOne,Tick,291,329,-38,38,147000,146500,6541,-9341,-16941,OK
62.469,TraderOne,Tick,291,339,-48,48,146700,146300,6835,-3635,-13235,OK
62.719,TraderOne,Tick,291,339,-48,48,146700,146300,6835,-3635,-13235,OK
63.016,TraderOne,Tick,291,339,-48,48,146700,146300,6835,-3635,-13235,OK
63.25,TraderOne,Tick,291,339,-48,48,146700,146300,6835,-3635,-13235,OK
63.547,TraderOne,Tick,291,339,-48,48,146700,146300,6835,-3635,-13235,OK
63.766,TraderOne,Tick,291,339,-48,48,146700,146300,6835,-3635,-13235,OK
64.031,TraderOne,Tick,291,339,-48,48,146700,146300,6835,-3635,-13235,OK
64.219,TraderOne,Tick,301,339,-38,38,146700,146300,7129,-7929,-15529,OK
64.516,TraderOne,Tick,301,339,-38,38,146700,146300,7129,-7929,-15529,OK
64.766,TraderOne,Tick,301,339,-38,38,146700,146300,7129,-7929,-15529,OK
65.016,TraderOne,Tick,301,339,-38,38,146700,146300,7129,-7929,-15529,OK
65.266,TraderOne,Tick,301,339,-38,38,146700,146900,7129,-7929,-329,OK
65.469,TraderOne,Tick,301,339,-38,38,146700,146900,7129,-7929,-329,OK
65.719,TraderOne,Tick,301,339,-38,38,146700,146900,7129,-7929,-329,OK
66.047,TraderOne,Tick,311,339,-28,28,146600,146900,6982,-11782,-6182,OK
66.219,TraderOne,Tick,311,339,-28,28,146600,146900,6982,-11782,-6182,OK
66.469,TraderOne,Tick,311,349,-38,38,147300,146900,6835,-7635,-15235,OK
66.719,TraderOne,Tick,311,349,-38,38,147300,146900,6835,-7635,-15235,OK
67.031,TraderOne,Tick,321,349,-28,28,146500,146900,6688,-11488,-5888,OK
67.219,TraderOne,Tick,321,349,-28,28,146500,146900,6688,-11488,-5888,OK
67.516,TraderOne,Tick,331,349,-18,18,146900,146900,6541,-13341,-13341,OK
67.781,TraderOne,Tick,341,349,-8,8,146900,146900,6835,-15635,-15635,OK
68.0,TraderOne,Tick,341,349,-8,8,146900,146900,6835,-15635,-15635,OK
68.266,TraderOne,Tick,341,359,-18,18,146900,146900,6688,-15488,-15488,OK
68.531,TraderOne,Tick,351,369,-18,18,146500,146900,6835,-14635,-11035,OK
68.766,TraderOne,Tick,351,369,-18,18,146500,147200,6835,-14635,-11035,OK
69.016,TraderOne,Tick,351,369,-18,18,146500,147200,6835,-14635,-11035,OK
69.219,TraderOne,Tick,351,379,-28,28,147500,147200,6688,-12488,-18088,OK
69.531,TraderOne,Tick,351,379,-28,28,147500,147200,6688,-12488,-18088,OK
69.719,TraderOne,Tick,351,379,-28,28,147500,147300,6688,-12488,-18088,OK
69.969,TraderOne,Tick,351,379,-28,28,147500,147300,6688,-12488,-18088,OK
70.25,TraderOne,Tick,351,379,-28,28,147500,147300,6688,-12488,-18088,OK
70.563,TraderOne,Tick,351,379,-28,28,147500,147300,6688,-12488,-18088,OK
70.797,TraderOne,Tick,361,379,-18,18,146500,147300,6541,-15341,-11741,OK
71.0,TraderOne,Tick,361,379,-18,18,146500,147300,6541,-15341,-11741,OK
71.297,TraderOne,Tick,361,379,-18,18,146500,147300,6541,-15341,-11741,OK
71.531,TraderOne,Tick,361,379,-18,18,146500,147300,6541,-15341,-11741,OK
71.719,TraderOne,Tick,361,379,-18,18,146500,147300,6541,-15341,-11741,OK
71.984,TraderOne,Tick,361,379,-18,18,146500,147300,6541,-15341,-11741,OK
72.203,TraderOne,Tick,361,379,-18,18,146500,147300,6541,-15341,-11741,OK
72.484,TraderOne,Tick,361,389,-28,28,147500,147300,6393,-14193,-19793,OK
72.734,TraderOne,Tick,361,389,-28,28,147500,147300,6393,-14193,-19793,OK
73.063,TraderOne,Tick,371,389,-18,18,147600,147300,6688,-17488,-21088,OK
73.281,TraderOne,Tick,371,389,-18,18,147600,147300,6688,-17488,-21088,OK
73.531,TraderOne,Tick,371,389,-18,18,147600,147200,6688,-17488,-21088,OK
73.719,TraderOne,Tick,371,389,-18,18,147600,147200,6688,-17488,-21088,OK
74.0,TraderOne,Tick,371,389,-18,18,147600,147200,6688,-17488,-21088,OK
74.25,TraderOne,Tick,381,389,-8,8,147600,147200,6983,-19783,-21383,OK
74.547,TraderOne,Tick,381,399,-18,18,147500,147200,7278,-19078,-22678,OK
74.766,TraderOne,Tick,381,399,-18,18,147500,147200,7278,-19078,-22678,OK
75.0,TraderOne,Tick,381,399,-18,18,147500,147200,7278,-19078,-22678,OK
75.266,TraderOne,Tick,381,399,-18,18,147500,147400,7278,-19078,-20878,OK
75.469,TraderOne,Tick,381,399,-18,18,147500,147400,7278,-19078,-20878,OK
75.703,TraderOne,Tick,381,399,-18,18,147500,147400,7278,-19078,-20878,OK
76.016,TraderOne,Tick,381,399,-18,18,147500,147400,7278,-19078,-20878,OK
76.281,TraderOne,Tick,381,399,-18,18,147500,147400,7278,-19078,-20878,OK
76.516,TraderOne,Tick,391,399,-8,8,147600,147500,7573,-21373,-22173,OK
76.797,TraderOne,Tick,401,399,2,-2,147600,147600,7868,-22668,-22668,OK
77.016,TraderOne,Tick,401,399,2,-2,147600,147600,7868,-22668,-22668,OK
77.281,TraderOne,Tick,401,409,-8,8,147500,147600,8163,-21963,-21163,OK
77.516,TraderOne,Tick,401,419,-18,18,147500,147600,8458,-21258,-19458,OK
77.719,TraderOne,Tick,411,419,-8,8,147400,147600,8311,-23111,-21511,OK
78.0,TraderOne,Tick,411,419,-8,8,147400,147600,8311,-23111,-21511,OK
78.281,TraderOne,Tick,411,419,-8,8,147400,147600,8311,-23111,-21511,OK
78.484,TraderOne,Tick,421,419,2,-2,147400,147600,8606,-24406,-24806,OK
78.719,TraderOne,Tick,421,419,2,-2,147400,147600,8606,-24406,-24806,OK
78.984,TraderOne,Tick,421,419,2,-2,147400,147600,8606,-24406,-24806,OK
79.25,TraderOne,Tick,431,419,12,-12,147400,147600,8901,-22701,-25101,OK
79.453,TraderOne,Tick,441,419,22,-22,147400,147600,9196,-20996,-25396,OK
79.781,TraderOne,Tick,451,419,32,-32,147600,148500,9491,-19091,-25491,OK
79.969,TraderOne,Tick,461,419,42,-42,147800,148400,9787,-13387,-21787,OK
80.297,TraderOne,Tick,465,419,46,-46,147800,148400,9905,-11905,-21105,OK
80.5,TraderOne,Tick,475,419,56,-56,147900,148400,10201,-8201,-19401,OK
80.703,TraderOne,Tick,475,419,56,-56,147900,148400,10201,-8201,-19401,OK
81.047,TraderOne,Tick,475,419,56,-56,147900,148400,10201,-8201,-19401,OK
81.266,TraderOne,Tick,475,419,56,-56,147900,148200,10201,-8201,-19401,OK
81.531,TraderOne,Tick,475,419,56,-56,147900,148400,10201,-8201,-19401,OK
81.719,TraderOne,Tick,475,429,46,-46,148000,148400,10053,-17053,-26253,OK
82.016,TraderOne,Tick,485,429,56,-56,148000,148400,10349,-13349,-24549,OK
82.25,TraderOne,Tick,485,429,56,-56,148000,148400,10349,-13349,-24549,OK
82.469,TraderOne,Tick,495,429,66,-66,148200,148800,10645,-8645,-21845,OK
82.75,TraderOne,Tick,495,429,66,-66,148200,148800,10645,-8645,-21845,OK
83.0,TraderOne,Tick,495,429,66,-66,148200,148800,10645,-8645,-21845,OK
83.281,TraderOne,Tick,495,429,66,-66,148300,148800,10645,-8645,-21845,OK
83.5,TraderOne,Tick,495,429,66,-66,148300,148800,10645,-8645,-21845,OK
83.719,TraderOne,Tick,495,439,56,-56,148300,148800,10497,-15497,-26697,OK
84.031,TraderOne,Tick,495,439,56,-56,148400,149000,10497,-15497,-26697,OK
84.25,TraderOne,Tick,495,439,56,-56,148400,149000,10497,-15497,-26697,OK
84.469,TraderOne,Tick,495,439,56,-56,148400,149000,10497,-15497,-26697,OK
84.766,TraderOne,Tick,495,439,56,-56,148400,149200,10497,-15497,-26697,OK
85.0,TraderOne,Tick,505,439,66,-66,148600,149200,10794,-9794,-22994,OK
85.297,TraderOne,Tick,505,449,56,-56,148600,149200,11091,-16091,-27291,OK
85.5,TraderOne,Tick,505,459,46,-46,148800,149200,10942,-20942,-30142,OK
85.75,TraderOne,Tick,505,459,46,-46,148800,149200,10942,-20942,-30142,OK
86.016,TraderOne,Tick,515,459,56,-56,148800,149600,11240,-16240,-27440,OK
86.25,TraderOne,Tick,515,469,46,-46,149000,149600,11091,-23091,-32291,OK
86.469,TraderOne,Tick,515,469,46,-46,149000,149600,11091,-23091,-32291,OK
86.719,TraderOne,Tick,515,479,36,-36,149600,149600,10942,-25942,-25942,OK
87.0,TraderOne,Tick,515,479,36,-36,149600,149600,10942,-25942,-25942,OK
87.234,TraderOne,Tick,515,479,36,-36,149600,149600,10942,-25942,-25942,OK
87.516,TraderOne,Tick,515,479,36,-36,149600,149700,10942,-25942,-29542,OK
87.797,TraderOne,Tick,515,479,36,-36,149600,149500,10942,-25942,-22342,OK
88.078,TraderOne,Tick,515,479,36,-36,149600,149500,10942,-25942,-22342,OK
88.266,TraderOne,Tick,515,479,36,-36,149600,149500,10942,-25942,-22342,OK
88.453,TraderOne,Tick,515,479,36,-36,149600,149500,10942,-25942,-22342,OK
88.813,TraderOne,Tick,515,479,36,-36,149600,149100,10942,-25942,-18742,OK
89.016,TraderOne,Tick,515,479,36,-36,149600,149100,10942,-25942,-18742,OK
89.25,TraderOne,Tick,515,479,36,-36,149600,149100,10942,-25942,-18742,OK
89.438,TraderOne,Tick,515,479,36,-36,149600,148900,10942,-25942,-18742,OK
89.719,TraderOne,Tick,515,479,36,-36,149600,148900,10942,-25942,-18742,OK
89.969,TraderOne,Tick,515,479,36,-36,149600,148900,10942,-25942,-18742,OK
90.266,TraderOne,Tick,515,479,36,-36,149600,149100,10942,-25942,-18742,OK
90.484,TraderOne,Tick,515,479,36,-36,149600,149100,10942,-25942,-18742,OK
90.75,TraderOne,Tick,515,479,36,-36,149600,149100,10942,-25942,-18742,OK
91.016,TraderOne,Tick,515,489,26,-26,148800,149100,10793,-28793,-33993,OK
91.297,TraderOne,Tick,515,499,16,-16,149400,149100,11092,-26092,-22892,OK
91.516,TraderOne,Tick,515,504,11,-11,149400,148900,11241,-24241,-22041,OK
91.719,TraderOne,Tick,515,509,6,-6,149600,148900,11167,-25167,-23967,OK
91.984,TraderOne,Tick,515,513,2,-2,149500,148900,11287,-23687,-23287,OK
92.25,TraderOne,Tick,525,513,12,-12,148500,148900,11138,-23538,-25938,OK
92.469,TraderOne,Tick,525,513,12,-12,148500,148900,11138,-23538,-25938,OK
92.75,TraderOne,Tick,525,513,12,-12,148500,148900,11138,-23538,-25938,OK
92.953,TraderOne,Tick,525,513,12,-12,148500,148900,11138,-23538,-25938,OK
93.188,TraderOne,Tick,525,513,12,-12,148500,149200,11138,-23538,-25938,OK
93.5,TraderOne,Tick,525,513,12,-12,148500,149200,11138,-23538,-25938,OK
93.75,TraderOne,Tick,525,513,12,-12,148500,149200,11138,-23538,-25938,OK
94.047,TraderOne,Tick,525,513,12,-12,148500,149200,11138,-23538,-25938,OK
94.281,TraderOne,Tick,525,513,12,-12,148500,149200,11138,-23538,-25938,OK
94.469,TraderOne,Tick,525,513,12,-12,148500,149200,11138,-23538,-25938,OK
94.719,TraderOne,Tick,525,513,12,-12,148500,149200,11138,-23538,-25938,OK
94.984,TraderOne,Tick,525,513,12,-12,148500,149200,11138,-23538,-25938,OK
95.25,TraderOne,Tick,525,513,12,-12,148500,149200,11138,-23538,-25938,OK
95.453,TraderOne,Tick,525,513,12,-12,148500,149200,11138,-23538,-25938,OK
95.781,TraderOne,Tick,525,513,12,-12,148500,149200,11138,-23538,-25938,OK
96.0,TraderOne,Tick,525,513,12,-12,148500,149200,11138,-23538,-25938,OK
96.281,TraderOne,Tick,525,513,12,-12,148500,149200,11138,-23538,-25938,OK
96.516,TraderOne,Tick,525,513,12,-12,148500,149200,11138,-23538,-25938,OK
96.781,TraderOne,Tick,531,513,18,-18,149600,149200,11318,-23118,-19518,OK
96.969,TraderOne,Tick,531,513,18,-18,149600,149200,11318,-23118,-19518,OK
97.266,TraderOne,Tick,531,513,18,-18,149600,149200,11318,-23118,-19518,OK
97.5,TraderOne,Tick,541,523,18,-18,149800,149600,11018,-22818,-19218,OK
97.734,TraderOne,Tick,541,523,18,-18,149800,149600,11018,-22818,-19218,OK
97.969,TraderOne,Tick,541,523,18,-18,149800,149800,11018,-22818,-22818,OK
98.219,TraderOne,Tick,541,523,18,-18,149800,149800,11018,-22818,-22818,OK
98.469,TraderOne,Tick,551,523,28,-18,149200,149800,10868,-1518668,-29068,OK
98.75,TraderOne,Tick,551,533,18,-18,149800,149800,10718,-23518,-23518,OK
98.984,TraderOne,Tick,551,533,18,-18,149800,149900,10718,-23518,-25318,OK
99.25,TraderOne,Tick,551,533,18,-18,149800,150100,10718,-23518,-28918,OK
99.563,TraderOne,Tick,561,533,28,-28,149800,150000,11018,-21818,-27418,OK
99.703,TraderOne,Tick,571,533,38,-38,149800,150000,11318,-20118,-27718,OK
100.0,TraderOne,Tick,571,533,38,-38,149900,150000,11318,-20118,-23918,OK
100.234,TraderOne,Tick,571,533,38,-38,149900,149900,11318,-20118,-20118,OK
100.484,TraderOne,Tick,571,533,38,-38,149900,149900,11318,-20118,-20118,OK
100.766,TraderOne,Tick,571,533,38,-38,149900,149900,11318,-20118,-20118,OK
101.047,TraderOne,Tick,571,533,38,-38,149900,149900,11318,-20118,-20118,OK
101.25,TraderOne,Tick,581,533,48,-48,149400,149900,11168,-16968,-31368,OK
101.547,TraderOne,Tick,581,533,48,-48,149400,150100,11168,-16968,-31368,OK
101.719,TraderOne,Tick,581,543,38,-48,149700,150100,11018,1480182,-32218,OK
102.031,TraderOne,Tick,581,543,38,-38,149700,150100,11018,-20818,-32218,OK
102.266,TraderOne,Tick,581,543,38,-38,149700,150100,11018,-20818,-32218,OK
102.5,TraderOne,Tick,581,543,38,-38,149700,150100,11018,-20818,-32218,OK
102.797,TraderOne,Tick,591,543,48,-48,149900,150300,11318,-18118,-32518,OK
103.031,TraderOne,Tick,591,543,48,-48,149900,150300,11318,-18118,-32518,OK
103.203,TraderOne,Tick,591,543,48,-48,149900,150300,11318,-18118,-32518,OK
103.516,TraderOne,Tick,595,553,42,-42,149900,150300,11108,-20908,-33508,OK
103.719,TraderOne,Tick,595,563,32,-32,150100,150300,11408,-24208,-30608,OK
104.0,TraderOne,Tick,595,565,30,-30,150100,150400,11468,-24668,-33668,OK
104.313,TraderOne,Tick,595,565,30,-30,150100,150200,11468,-24668,-27668,OK
104.469,TraderOne,Tick,595,565,30,-30,150100,150200,11468,-24668,-27668,OK
104.719,TraderOne,Tick,595,565,30,-30,150100,150200,11468,-24668,-27668,OK
104.984,TraderOne,Tick,595,565,30,-30,150100,150200,11468,-24668,-27668,OK
105.297,TraderOne,Tick,595,565,30,-30,150100,150200,11468,-24668,-27668,OK
105.516,TraderOne,Tick,595,565,30,-30,150100,150200,11468,-24668,-27668,OK
105.719,TraderOne,Tick,595,565,30,-30,150100,150200,11468,-24668,-27668,OK
106.031,TraderOne,Tick,595,565,30,-30,150100,150300,11468,-24668,-30668,OK
106.266,TraderOne,Tick,595,565,30,-30,150100,150500,11468,-24668,-33668,OK
106.516,TraderOne,Tick,605,565,40,-40,150200,150500,11318,-21518,-33518,OK
106.734,TraderOne,Tick,605,565,40,-40,150200,150400,11318,-21518,-29518,OK
107.047,TraderOne,Tick,605,565,40,-40,150200,150300,11318,-21518,-25518,OK
107.297,TraderOne,Tick,605,565,40,-40,150200,150300,11318,-21518,-25518,OK
107.5,TraderOne,Tick,605,565,40,-40,150200,150400,11318,-21518,-29518,OK
107.703,TraderOne,Tick,605,565,40,-40,150200,150400,11318,-21518,-29518,OK
108.0,TraderOne,Tick,605,565,40,-40,150200,150400,11318,-21518,-29518,OK
108.234,TraderOne,Tick,605,565,40,-40,150200,150300,11318,-21518,-25518,OK
108.547,TraderOne,Tick,605,565,40,-40,150200,150100,11318,-21518,-17518,OK
108.766,TraderOne,Tick,615,565,50,-40,149600,150100,11168,-1518368,-32368,OK
109.016,TraderOne,Tick,615,575,40,-40,149600,150100,11467,-23667,-35667,OK
109.313,TraderOne,Tick,615,575,40,-40,149600,150100,11467,-23667,-35667,OK
109.547,TraderOne,Tick,615,585,30,-30,149900,150100,11317,-26517,-32517,OK
109.797,TraderOne,Tick,615,595,20,-20,150100,150100,11617,-27817,-27817,OK
109.984,TraderOne,Tick,615,605,10,-10,150100,150100,11917,-28117,-28117,OK
110.203,TraderOne,Tick,615,615,0,0,150200,150500,12217,-31417,-31417,OK
110.531,TraderOne,Tick,625,615,10,-10,150200,150500,12517,-29717,-32717,OK
110.703,TraderOne,Tick,635,615,20,-20,150200,150700,12817,-27017,-33017,OK
110.953,TraderOne,Tick,645,615,30,-30,150200,150600,13117,-23317,-32317,OK
111.281,TraderOne,Tick,655,615,40,-40,150200,150600,13417,-19617,-31617,OK
111.516,TraderOne,Tick,655,616,39,-39,150200,150600,13402,-20002,-31702,OK
111.766,TraderOne,Tick,665,616,49,-49,150100,150600,13252,-16852,-31552,OK
111.969,TraderOne,Tick,665,616,49,-49,150100,150600,13252,-16852,-31552,OK
112.203,TraderOne,Tick,665,616,49,-49,150100,150500,13252,-16852,-31552,OK
112.5,TraderOne,Tick,665,626,39,-39,150100,150400,13552,-21152,-32852,OK
112.719,TraderOne,Tick,665,626,39,-39,150100,150500,13552,-21152,-32852,OK
113.016,TraderOne,Tick,665,626,39,-39,150100,150700,13552,-21152,-32852,OK
113.203,TraderOne,Tick,665,626,39,-39,150100,150600,13552,-21152,-32852,OK
113.5,TraderOne,Tick,665,626,39,-39,150100,150500,13552,-21152,-32852,OK
113.75,TraderOne,Tick,665,626,39,-39,150100,150500,13552,-21152,-32852,OK
114.047,TraderOne,Tick,665,626,39,-39,150100,150500,13552,-21152,-32852,OK
114.219,TraderOne,Tick,665,626,39,-39,150100,150600,13552,-21152,-32852,OK
114.547,TraderOne,Tick,665,636,29,-29,150500,150500,13402,-23002,-23002,OK
114.797,TraderOne,Tick,665,636,29,-29,150500,150500,13402,-23002,-23002,OK
114.984,TraderOne,Tick,665,636,29,-29,150500,150900,13402,-23002,-31702,OK
115.203,TraderOne,Tick,675,636,39,-39,150500,150500,13703,-21303,-21303,OK
115.469,TraderOne,Tick,675,643,32,-32,150100,150500,13913,-23613,-33213,OK
115.75,TraderOne,Tick,675,643,32,-32,150100,150500,13913,-23613,-33213,OK
115.969,TraderOne,Tick,675,645,30,-30,150100,150400,13973,-24273,-33273,OK
116.281,TraderOne,Tick,675,655,20,-20,150600,150500,13823,-27123,-25123,OK
116.531,TraderOne,Tick,675,655,20,-20,150600,150800,13823,-27123,-31123,OK
116.766,TraderOne,Tick,675,655,20,-20,150600,150500,13823,-27123,-25123,OK
117.047,TraderOne,Tick,685,655,30,-30,150000,150500,13673,-24973,-33973,OK
117.297,TraderOne,Tick,685,655,30,-30,150000,150300,13673,-24973,-33973,OK
117.516,TraderOne,Tick,685,655,30,-30,150000,150300,13673,-24973,-33973,OK
117.766,TraderOne,Tick,685,655,30,-30,150000,150300,13673,-24973,-33973,OK
118.0,TraderOne,Tick,685,655,30,-30,150000,150300,13673,-24973,-33973,OK
118.266,TraderOne,Tick,685,655,30,-30,150000,150300,13673,-24973,-33973,OK
118.453,TraderOne,Tick,685,665,20,-20,150200,150500,13523,-27823,-33823,OK
118.781,TraderOne,Tick,685,672,13,-13,150500,150300,13734,-28734,-26134,OK
118.969,TraderOne,Tick,685,672,13,-13,150500,150300,13734,-28734,-26134,OK
119.25,TraderOne,Tick,695,672,23,-23,150200,150300,14034,-28034,-30334,OK
119.547,TraderOne,Tick,695,672,23,-23,150200,150300,14034,-28034,-30334,OK
119.703,TraderOne,Tick,695,672,23,-23,150200,150100,14034,-28034,-25734,OK
119.984,TraderOne,Tick,695,672,23,-23,150200,150100,14034,-28034,-25734,OK
120.234,TraderOne,Tick,695,682,13,-13,150200,150600,13884,-35884,-39784,OK
120.484,TraderOne,Tick,701,682,19,-19,150200,150600,14064,-33664,-39364,OK
120.719,TraderOne,Tick,701,682,19,-19,150200,150600,14064,-33664,-39364,OK
121.047,TraderOne,Tick,701,682,19,-19,150200,150600,14064,-33664,-39364,OK
121.281,TraderOne,Tick,711,682,29,-29,150000,150600,13914,-32514,-41214,OK
121.484,TraderOne,Tick,711,682,29,-29,150000,150600,13914,-32514,-41214,OK
121.781,TraderOne,Tick,711,682,29,-29,150000,150600,13914,-32514,-41214,OK
122.0,TraderOne,Tick,721,682,39,-39,150100,150600,14215,-32815,-44515,OK
122.234,TraderOne,Tick,721,682,39,-39,150100,150600,14215,-32815,-44515,OK
122.563,TraderOne,Tick,721,682,39,-39,150100,150500,14215,-32815,-44515,OK
122.766,TraderOne,Tick,721,682,39,-39,150100,150500,14215,-32815,-44515,OK
122.984,TraderOne,Tick,721,682,39,-39,150100,150500,14215,-32815,-44515,OK
123.25,TraderOne,Tick,721,682,39,-39,150100,150400,14215,-32815,-44515,OK
123.469,TraderOne,Tick,721,682,39,-39,150100,150400,14215,-32815,-44515,OK
123.781,TraderOne,Tick,721,692,29,-29,150400,150400,14065,-35665,-35665,OK
123.969,TraderOne,Tick,721,702,19,-19,150400,150400,13915,-37515,-37515,OK
124.281,TraderOne,Tick,721,712,9,-9,150600,150400,14216,-38816,-37016,OK
124.547,TraderOne,Tick,721,712,9,-9,150600,150400,14216,-38816,-37016,OK
124.734,TraderOne,Tick,721,712,9,-9,150600,150400,14216,-38816,-37016,OK
124.969,TraderOne,Tick,721,712,9,-9,150600,150400,14216,-38816,-37016,OK
125.266,TraderOne,Tick,721,712,9,-9,150600,150400,14216,-38816,-37016,OK
125.484,TraderOne,Tick,721,712,9,-9,150400,150400,14216,-38816,-38816,OK
125.781,TraderOne,Tick,721,712,9,-9,150400,150400,14216,-38816,-38816,OK
126.016,TraderOne,Tick,731,712,19,-19,150500,150700,14517,-38117,-41917,OK
126.219,TraderOne,Tick,741,712,29,-29,150500,150900,14818,-37418,-46118,OK
126.547,TraderOne,Tick,751,712,39,-39,150500,151200,15119,-32719,-44419,OK
126.75,TraderOne,Tick,761,712,49,-49,150600,151000,15420,-29020,-43720,OK
127.047,TraderOne,Tick,761,722,39,-39,150500,151000,15721,-33321,-45021,OK
127.25,TraderOne,Tick,761,722,39,-39,150500,151000,15721,-33321,-45021,OK
127.484,TraderOne,Tick,761,722,39,-39,150500,150700,15721,-33321,-41121,OK
127.734,TraderOne,Tick,761,732,29,-29,150400,150400,16022,-35622,-35622,OK
128.016,TraderOne,Tick,761,742,19,-19,150700,150300,16323,-36923,-31223,OK
128.25,TraderOne,Tick,761,752,9,-9,150400,150300,16624,-37224,-36324,OK
128.563,TraderOne,Tick,761,752,9,-9,150400,150200,16624,-37224,-35424,OK
128.719,TraderOne,Tick,761,752,9,-9,150400,150200,16624,-37224,-35424,OK
129.047,TraderOne,Tick,761,752,9,-9,150400,150200,16624,-37224,-35424,OK
129.219,TraderOne,Tick,761,752,9,-9,150400,150200,16624,-37224,-35424,OK
129.547,TraderOne,Tick,761,762,-1,1,151000,150400,16474,-38074,-38374,OK
129.719,TraderOne,Tick,761,762,-1,1,151000,150400,16474,-38074,-38374,OK
129.984,TraderOne,Tick,761,762,-1,1,151000,150400,16474,-38074,-38374,OK
130.266,TraderOne,Tick,761,762,-1,1,151000,150400,16474,-38074,-38374,OK
130.5,TraderOne,Tick,761,762,-1,1,151000,150400,16474,-38074,-38374,OK
130.719,TraderOne,Tick,761,762,-1,1,151000,150400,16474,-38074,-38374,OK
131.016,TraderOne,Tick,771,762,9,-9,149800,150400,16324,-38924,-41624,OK
131.281,TraderOne,Tick,771,762,9,-9,149800,150100,16324,-38924,-41624,OK
131.547,TraderOne,Tick,771,762,9,-9,149800,150100,16324,-38924,-41624,OK
131.734,TraderOne,Tick,771,762,9,-9,149800,150100,16324,-38924,-41624,OK
132.016,TraderOne,Tick,771,772,-1,1,150800,150100,16174,-37774,-38074,OK
132.297,TraderOne,Tick,771,772,-1,1,150800,149800,16174,-37774,-38074,OK
132.5,TraderOne,Tick,771,772,-1,1,150800,149800,16174,-37774,-38074,OK
132.719,TraderOne,Tick,771,782,-11,11,149800,149600,16474,-36074,-38274,OK
133.016,TraderOne,Tick,771,782,-11,11,149800,149600,16474,-36074,-38274,OK
133.25,TraderOne,Tick,771,792,-21,21,150200,149600,16324,-33924,-38124,OK
133.547,TraderOne,Tick,771,792,-21,21,150200,149600,16324,-33924,-38124,OK
133.719,TraderOne,Tick,781,792,-11,11,149300,149500,16174,-36774,-34574,OK
134.031,TraderOne,Tick,781,792,-11,11,149300,149600,16174,-36774,-34574,OK
134.234,TraderOne,Tick,781,792,-11,11,149300,149600,16174,-36774,-34574,OK
134.531,TraderOne,Tick,781,792,-11,11,149300,149700,16174,-36774,-34574,OK
134.719,TraderOne,Tick,781,792,-11,11,149300,149700,16174,-36774,-34574,OK
134.969,TraderOne,Tick,781,792,-11,11,149300,149800,16174,-36774,-33474,OK
135.203,TraderOne,Tick,791,792,-1,11,149200,149800,16024,-1536624,-38324,OK
135.469,TraderOne,Tick,801,794,7,3,149800,149800,15844,-1537244,-39244,OK
135.734,TraderOne,Tick,811,794,17,-17,149300,149900,16143,-34543,-39643,OK
135.969,TraderOne,Tick,811,794,17,-17,149300,149900,16143,-34543,-39643,OK
136.219,TraderOne,Tick,811,794,17,-17,149300,149900,16143,-34543,-39643,OK
136.531,TraderOne,Tick,811,794,17,-17,149300,149900,16143,-34543,-39643,OK
136.766,TraderOne,Tick,811,794,17,-17,149300,149800,16143,-34543,-39643,OK
137.016,TraderOne,Tick,811,794,17,-17,149300,149600,16143,-34543,-37943,OK
137.313,TraderOne,Tick,811,794,17,-17,149300,149600,16143,-34543,-37943,OK
137.531,TraderOne,Tick,811,794,17,-17,149300,149600,16143,-34543,-37943,OK
137.703,TraderOne,Tick,811,794,17,-17,149300,149300,16143,-34543,-34543,OK
137.969,TraderOne,Tick,811,794,17,-17,149300,149300,16143,-34543,-34543,OK
138.25,TraderOne,Tick,811,794,17,-17,149300,149300,16143,-34543,-34543,OK
138.563,TraderOne,Tick,811,794,17,-17,149300,149300,16143,-34543,-34543,OK
138.766,TraderOne,Tick,811,794,17,-17,149300,149100,16143,-34543,-31143,OK
139.047,TraderOne,Tick,811,794,17,-17,149300,149100,16143,-34543,-31143,OK
139.203,TraderOne,Tick,811,794,17,-17,149300,149100,16143,-34543,-31143,OK
139.5,TraderOne,Tick,811,794,17,-17,149300,149300,16143,-34543,-34543,OK
139.797,TraderOne,Tick,811,794,17,-17,149300,149300,16143,-34543,-34543,OK
140.016,TraderOne,Tick,811,794,17,-17,149300,149300,16143,-34543,-34543,OK
140.219,TraderOne,Tick,811,794,17,-17,149300,149300,16143,-34543,-34543,OK
140.516,TraderOne,Tick,811,801,10,-10,149700,149300,16038,-35138,-33138,OK
140.719,TraderOne,Tick,811,801,10,-10,149700,149300,16038,-35138,-33138,OK
141.016,TraderOne,Tick,811,801,10,-10,149700,149300,16038,-35138,-33138,OK
141.25,TraderOne,Tick,811,811,0,0,149500,149300,16337,-36437,-36437,OK
141.531,TraderOne,Tick,811,821,-10,10,150200,149300,16187,-36287,-38287,OK
141.719,TraderOne,Tick,811,821,-10,10,150200,149500,16187,-36287,-38287,OK
142.016,TraderOne,Tick,811,821,-10,10,150200,149500,16187,-36287,-38287,OK
142.313,TraderOne,Tick,811,821,-10,10,150200,149500,16187,-36287,-38287,OK
142.484,TraderOne,Tick,811,821,-10,10,150200,149500,16187,-36287,-38287,OK
142.797,TraderOne,Tick,811,831,-20,20,150200,149500,16037,-35137,-39137,OK
142.984,TraderOne,Tick,811,831,-20,20,150200,149500,16037,-35137,-39137,OK
143.281,TraderOne,Tick,811,831,-20,20,150200,149500,16037,-35137,-39137,OK
143.484,TraderOne,Tick,811,831,-20,20,150200,149700,16037,-35137,-39137,OK
143.797,TraderOne,Tick,811,841,-30,30,150200,149700,15887,-32987,-38987,OK
144.016,TraderOne,Tick,821,841,-20,20,149200,149700,15737,-35837,-31837,OK
144.219,TraderOne,Tick,821,841,-20,20,149200,149700,15737,-35837,-31837,OK
144.469,TraderOne,Tick,831,841,-10,10,149100,149700,15587,-37687,-35687,OK
144.766,TraderOne,Tick,831,841,-10,10,149100,149700,15587,-37687,-35687,OK
144.953,TraderOne,Tick,831,841,-10,10,149100,149700,15587,-37687,-35687,OK
145.219,TraderOne,Tick,831,841,-10,10,149100,149700,15587,-37687,-35687,OK
145.547,TraderOne,Tick,831,841,-10,10,149100,149700,15587,-37687,-35687,OK
145.75,TraderOne,Tick,831,841,-10,10,149100,149700,15587,-37687,-35687,OK
145.969,TraderOne,Tick,831,841,-10,10,149100,149700,15587,-37687,-35687,OK
146.234,TraderOne,Tick,831,841,-10,10,149100,149700,15587,-37687,-35687,OK
146.484,TraderOne,Tick,831,841,-10,10,149100,149500,15587,-37687,-35687,OK
146.719,TraderOne,Tick,831,841,-10,10,149100,149700,15587,-37687,-35687,OK
147.016,TraderOne,Tick,831,841,-10,10,149100,149700,15587,-37687,-35687,OK
147.297,TraderOne,Tick,831,841,-10,10,149100,149700,15587,-37687,-35687,OK
147.516,TraderOne,Tick,831,841,-10,10,149100,149600,15587,-37687,-35687,OK
147.734,TraderOne,Tick,831,841,-10,10,149100,149600,15587,-37687,-35687,OK
147.984,TraderOne,Tick,831,841,-10,10,149100,149600,15587,-37687,-35687,OK
148.25,TraderOne,Tick,831,841,-10,10,149100,149600,15587,-37687,-35687,OK
148.531,TraderOne,Tick,831,841,-10,10,149100,149600,15587,-37687,-35687,OK
148.719,TraderOne,Tick,831,841,-10,10,149100,149600,15587,-37687,-35687,OK
148.984,TraderOne,Tick,831,841,-10,10,149100,149600,15587,-37687,-35687,OK
149.234,TraderOne,Tick,831,841,-10,10,149100,149600,15587,-37687,-35687,OK
149.531,TraderOne,Tick,831,851,-20,20,150600,150100,15437,-34537,-40537,OK
149.797,TraderOne,Tick,831,851,-20,20,150600,150100,15437,-34537,-40537,OK
149.969,TraderOne,Tick,831,851,-20,20,150600,150100,15437,-34537,-40537,OK
150.203,TraderOne,Tick,831,851,-20,20,150600,150100,15437,-34537,-40537,OK
150.469,TraderOne,Tick,831,858,-27,27,150000,150100,15647,-33347,-30647,OK
150.75,TraderOne,Tick,831,858,-27,27,150000,150100,15647,-33347,-30647,OK
150.984,TraderOne,Tick,831,858,-27,27,150000,150100,15647,-33347,-30647,OK
151.203,TraderOne,Tick,831,858,-27,27,150000,150100,15647,-33347,-30647,OK
151.516,TraderOne,Tick,831,858,-27,27,150000,150100,15647,-33347,-30647,OK
151.719,TraderOne,Tick,831,858,-27,27,150000,150100,15647,-33347,-30647,OK
152.0,TraderOne,Tick,831,858,-27,27,150000,150100,15647,-33347,-30647,OK
152.219,TraderOne,Tick,831,858,-27,27,150000,150100,15647,-33347,-30647,OK
152.547,TraderOne,Tick,831,858,-27,27,150000,150100,15647,-33347,-30647,OK
152.734,TraderOne,Tick,831,858,-27,27,150000,150100,15647,-33347,-30647,OK
152.969,TraderOne,Tick,831,868,-37,37,150400,150100,15497,-30197,-41297,OK
153.281,TraderOne,Tick,831,868,-37,37,150400,149800,15497,-30197,-41297,OK
153.531,TraderOne,Tick,831,868,-37,37,150400,149800,15497,-30197,-41297,OK
153.75,TraderOne,Tick,831,868,-37,37,150400,149800,15497,-30197,-41297,OK
153.953,TraderOne,Tick,831,868,-37,37,150400,150100,15497,-30197,-41297,OK
154.281,TraderOne,Tick,831,868,-37,37,150400,150100,15497,-30197,-41297,OK
154.484,TraderOne,Tick,831,868,-37,37,150400,150100,15497,-30197,-41297,OK
154.766,TraderOne,Tick,831,868,-37,37,150400,150100,15497,-30197,-41297,OK
154.984,TraderOne,Tick,841,868,-27,27,150600,150100,15798,-33498,-41598,OK
155.266,TraderOne,Tick,851,868,-17,17,150600,150100,16099,-36799,-41899,OK
155.469,TraderOne,Tick,851,868,-17,17,150600,150300,16099,-36799,-41899,OK
155.766,TraderOne,Tick,851,868,-17,17,150600,150300,16099,-36799,-41899,OK
156.0,TraderOne,Tick,851,868,-17,17,150600,150300,16099,-36799,-41899,OK
156.266,TraderOne,Tick,851,868,-17,17,150600,150300,16099,-36799,-41899,OK
156.547,TraderOne,Tick,851,868,-17,17,150600,150300,16099,-36799,-41899,OK
156.703,TraderOne,Tick,851,868,-17,17,150600,150300,16099,-36799,-41899,OK
157.031,TraderOne,Tick,851,868,-17,17,150600,150300,16099,-36799,-41899,OK
157.25,TraderOne,Tick,851,868,-17,17,150600,150300,16099,-36799,-41899,OK
157.516,TraderOne,Tick,851,868,-17,17,150600,150300,16099,-36799,-41899,OK
157.703,TraderOne,Tick,851,868,-17,17,150600,150300,16099,-36799,-41899,OK
157.984,TraderOne,Tick,851,868,-17,17,150600,150300,16099,-36799,-41899,OK
158.297,TraderOne,Tick,851,868,-17,17,150600,150300,16099,-36799,-41899,OK
158.516,TraderOne,Tick,851,868,-17,17,150500,150300,16099,-36799,-40199,OK
158.75,TraderOne,Tick,851,868,-17,17,150500,150300,16099,-36799,-40199,OK
158.969,TraderOne,Tick,861,868,-7,7,150600,150400,16400,-39100,-40500,OK
159.25,TraderOne,Tick,861,868,-7,7,150600,150400,16400,-39100,-40500,OK
159.516,TraderOne,Tick,861,878,-17,17,150500,150400,16701,-38401,-40101,OK
159.813,TraderOne,Tick,870,878,-8,8,150600,150400,16972,-40472,-42072,OK
159.984,TraderOne,Tick,870,878,-8,8,150600,150400,16972,-40472,-42072,OK
160.219,TraderOne,Tick,870,880,-10,8,150700,150400,16942,260958,-42842,OK
160.531,TraderOne,Tick,870,886,-16,16,150600,150400,16852,-38752,-41952,OK
160.75,TraderOne,Tick,870,894,-24,24,150500,150200,17093,-38193,-45393,OK
161.016,TraderOne,Tick,870,894,-24,24,150500,150200,17093,-38193,-45393,OK
161.297,TraderOne,Tick,870,894,-24,24,150500,150200,17093,-38193,-45393,OK
161.5,TraderOne,Tick,870,894,-24,24,150500,150200,17093,-38193,-45393,OK
161.734,TraderOne,Tick,870,894,-24,24,150500,150200,17093,-38193,-45393,OK
162.063,TraderOne,Tick,870,894,-24,24,150500,150200,17093,-38193,-45393,OK
162.313,TraderOne,Tick,880,894,-14,14,150800,150800,17395,-41495,-41495,OK
162.5,TraderOne,Tick,880,894,-14,14,150800,150800,17395,-41495,-41495,OK
162.719,TraderOne,Tick,880,894,-14,14,150800,150800,17395,-41495,-41495,OK
163.016,TraderOne,Tick,880,894,-14,14,150800,150700,17395,-41495,-42895,OK
163.281,TraderOne,Tick,881,894,-13,13,150800,150800,17380,-41580,-41580,OK
163.5,TraderOne,Tick,881,894,-13,13,150800,150800,17380,-41580,-41580,OK
163.719,TraderOne,Tick,881,894,-13,13,150800,150800,17380,-41580,-41580,OK
163.953,TraderOne,Tick,891,894,-3,3,151000,150800,17682,-43882,-44482,OK
164.219,TraderOne,Tick,901,894,7,-7,151000,151000,17984,-45184,-45184,OK
164.516,TraderOne,Tick,901,894,7,-7,151000,150900,17984,-45184,-44484,OK
164.734,TraderOne,Tick,901,904,-3,-7,151200,150900,17833,1465967,-43933,OK
164.969,TraderOne,Tick,901,904,-3,3,151200,151000,17833,-44033,-44633,OK
165.219,TraderOne,Tick,901,904,-3,3,151200,151000,17833,-44033,-44633,OK
165.547,TraderOne,Tick,901,914,-13,13,151400,151000,17682,-41882,-45782,OK
165.797,TraderOne,Tick,901,914,-13,13,151400,151000,17682,-41882,-45782,OK
165.984,TraderOne,Tick,901,914,-13,13,151400,151000,17682,-41882,-45782,OK
166.297,TraderOne,Tick,901,914,-13,13,151400,151100,17682,-41882,-45782,OK
166.531,TraderOne,Tick,901,914,-13,13,151400,151100,17682,-41882,-45782,OK
166.734,TraderOne,Tick,901,914,-13,13,151400,151100,17682,-41882,-45782,OK
166.969,TraderOne,Tick,901,914,-13,13,151400,151100,17682,-41882,-45782,OK
167.297,TraderOne,Tick,901,914,-13,13,151400,151100,17682,-41882,-45782,OK
167.5,TraderOne,Tick,901,914,-13,13,151400,151100,17682,-41882,-45782,OK
167.781,TraderOne,Tick,911,914,-3,3,151500,151100,17985,-44185,-45085,OK
168.0,TraderOne,Tick,911,914,-3,3,151500,151100,17985,-44185,-45085,OK
168.219,TraderOne,Tick,911,914,-3,3,151500,151100,17985,-44185,-45085,OK
168.453,TraderOne,Tick,911,914,-3,3,151500,151100,17985,-44185,-45085,OK
168.734,TraderOne,Tick,911,914,-3,3,151500,151100,17985,-44185,-45085,OK
169.047,TraderOne,Tick,911,914,-3,3,151500,151100,17985,-44185,-45085,OK
169.281,TraderOne,Tick,911,924,-13,13,151100,150500,17834,-43034,-46934,OK
169.5,TraderOne,Tick,911,924,-13,13,151100,150500,17834,-43034,-46934,OK
169.734,TraderOne,Tick,911,924,-13,13,151100,150800,17834,-43034,-46934,OK
170.047,TraderOne,Tick,911,924,-13,13,151100,150700,17834,-43034,-46934,OK
170.281,TraderOne,Tick,911,924,-13,13,151100,150700,17834,-43034,-46934,OK
170.516,TraderOne,Tick,911,924,-13,13,151100,150700,17834,-43034,-46934,OK
170.766,TraderOne,Tick,911,924,-13,13,151100,150500,17834,-43034,-46934,OK
171.0,TraderOne,Tick,911,924,-13,13,151100,150500,17834,-43034,-46934,OK
171.219,TraderOne,Tick,911,924,-13,13,151100,150500,17834,-43034,-46934,OK
171.547,TraderOne,Tick,915,924,-9,9,150600,150500,17774,-43374,-44274,OK
171.719,TraderOne,Tick,915,924,-9,9,150600,150500,17774,-43374,-44274,OK
172.016,TraderOne,Tick,921,934,-13,13,151200,150500,17533,-42733,-46633,OK
172.219,TraderOne,Tick,921,934,-13,13,151200,150500,17533,-42733,-46633,OK
172.516,TraderOne,Tick,921,934,-13,13,151200,150500,17533,-42733,-46633,OK
172.766,TraderOne,Tick,921,944,-23,23,151000,150500,17382,-40582,-47482,OK
173.047,TraderOne,Tick,921,944,-23,23,151000,150500,17382,-40582,-47482,OK
173.281,TraderOne,Tick,921,944,-23,23,151000,150500,17382,-40582,-47482,OK
173.516,TraderOne,Tick,921,944,-23,23,151000,150500,17382,-40582,-47482,OK
173.766,TraderOne,Tick,921,944,-23,23,151000,150500,17382,-40582,-47482,OK
173.953,TraderOne,Tick,921,944,-23,23,151000,150500,17382,-40582,-47482,OK
174.266,TraderOne,Tick,921,944,-23,23,151000,150500,17382,-40582,-47482,OK
174.547,TraderOne,Tick,921,944,-23,23,151000,150500,17382,-40582,-47482,OK
174.75,TraderOne,Tick,921,944,-23,23,151000,150600,17382,-40582,-47482,OK
175.047,TraderOne,Tick,931,944,-13,13,150800,150600,17684,-42884,-45484,OK
175.234,TraderOne,Tick,941,944,-3,3,150800,150600,17986,-45186,-45786,OK
175.516,TraderOne,Tick,941,944,-3,3,150800,150600,17986,-45186,-45786,OK
175.734,TraderOne,Tick,941,944,-3,3,150800,150600,17986,-45186,-45786,OK
176.016,TraderOne,Tick,941,944,-3,3,150800,150600,17986,-45186,-45786,OK
176.234,TraderOne,Tick,941,944,-3,3,150800,150600,17986,-45186,-45786,OK
176.531,TraderOne,Tick,951,944,7,-7,150700,150600,17835,-46035,-45335,OK
176.734,TraderOne,Tick,951,944,7,-7,150700,150600,17835,-46035,-45335,OK
177.0,TraderOne,Tick,951,944,7,-7,150700,150600,17835,-46035,-45335,OK
177.203,TraderOne,Tick,951,944,7,-7,150700,150600,17835,-46035,-45335,OK
177.5,TraderOne,Tick,951,954,-3,3,151200,150600,17684,-45884,-46784,OK
177.719,TraderOne,Tick,951,954,-3,3,151200,150300,17684,-45884,-46784,OK
178.016,TraderOne,Tick,951,954,-3,3,151200,150300,17684,-45884,-46784,OK
178.25,TraderOne,Tick,951,954,-3,3,151200,150300,17684,-45884,-46784,OK
178.5,TraderOne,Tick,951,954,-3,3,151200,150200,17684,-45884,-46784,OK
178.781,TraderOne,Tick,951,964,-13,13,150400,150200,17985,-44185,-46785,OK
179.0,TraderOne,Tick,951,974,-23,23,150400,150200,18286,-42486,-47086,OK
179.219,TraderOne,Tick,951,974,-23,23,150400,150200,18286,-42486,-47086,OK
179.5,TraderOne,Tick,951,974,-23,23,150400,149900,18286,-42486,-49386,OK
179.719,TraderOne,Tick,951,974,-23,23,150400,149900,18286,-42486,-49386,OK
179.969,TraderOne,Tick,951,974,-23,23,150100,149900,18286,-42486,-47086,OK
180.297,TraderOne,Tick,960,984,-24,24,150100,149800,18001,-41801,-49001,OK
180.469,TraderOne,Tick,960,984,-24,24,150100,149800,18001,-41801,-49001,OK
180.703,TraderOne,Tick,960,984,-24,24,150100,149900,18001,-41801,-46601,OK
181.0,TraderOne,Tick,960,984,-24,24,150100,149900,18001,-41801,-46601,OK
181.234,TraderOne,Tick,960,984,-24,24,150100,149900,18001,-41801,-46601,OK
181.547,TraderOne,Tick,970,984,-14,14,149700,149900,17851,-44651,-41851,OK
181.734,TraderOne,Tick,970,984,-14,14,149700,149900,17851,-44651,-41851,OK
181.984,TraderOne,Tick,970,984,-14,14,149700,149900,17851,-44651,-41851,OK
182.266,TraderOne,Tick,970,984,-14,14,149700,149900,17851,-44651,-41851,OK
182.453,TraderOne,Tick,970,984,-14,14,149700,149900,17851,-44651,-41851,OK
182.734,TraderOne,Tick,970,984,-14,14,149700,149900,17851,-44651,-41851,OK
183.0,TraderOne,Tick,970,984,-14,14,149700,149900,17851,-44651,-41851,OK
183.25,TraderOne,Tick,970,984,-14,14,149700,149900,17851,-44651,-41851,OK
183.547,TraderOne,Tick,970,984,-14,14,149700,150000,17851,-44651,-40451,OK
183.766,TraderOne,Tick,980,984,-4,4,150100,150000,17701,-46501,-46901,OK
184.047,TraderOne,Tick,983,984,-1,1,150100,150000,17656,-46756,-46856,OK
184.25,TraderOne,Tick,983,984,-1,1,150100,149700,17656,-46756,-46956,OK
184.531,TraderOne,Tick,983,984,-1,1,150100,149700,17656,-46756,-46956,OK
184.781,TraderOne,Tick,1003,984,19,-19,149700,149700,17805,-44905,-44905,OK
185.031,TraderOne,Tick,1013,984,29,-29,149700,150000,18104,-44204,-52904,OK
185.281,TraderOne,Tick,1013,984,29,-29,149700,150000,18104,-44204,-52904,OK
185.547,TraderOne,Tick,1013,984,29,-29,149700,150000,18104,-44204,-52904,OK
185.75,TraderOne,Tick,1013,984,29,-29,149700,150000,18104,-44204,-52904,OK
185.969,TraderOne,Tick,1013,984,29,-29,149700,150000,18104,-44204,-52904,OK
186.203,TraderOne,Tick,1013,984,29,-29,149700,149800,18104,-44204,-47104,OK
186.516,TraderOne,Tick,1013,994,19,-19,149600,149800,18403,-46503,-50303,OK
186.75,TraderOne,Tick,1013,994,19,-19,149600,149800,18403,-46503,-50303,OK
186.969,TraderOne,Tick,1023,994,29,-29,149700,149800,18702,-45802,-48702,OK
187.25,TraderOne,Tick,1023,994,29,-29,149700,149800,18702,-45802,-48702,OK
187.531,TraderOne,Tick,1023,994,29,-29,149700,150000,18702,-45802,-54502,OK
187.75,TraderOne,Tick,1033,994,39,-39,149700,150000,19001,-43101,-54801,OK
188.047,TraderOne,Tick,1043,994,49,-49,149700,150000,19300,-40400,-55100,OK
188.297,TraderOne,Tick,1049,994,55,-55,149700,150100,19210,-36710,-53210,OK
188.516,TraderOne,Tick,1049,1004,45,-45,149700,150100,19060,-43560,-57060,OK
188.719,TraderOne,Tick,1049,1004,45,-45,149700,150100,19060,-43560,-57060,OK
188.969,TraderOne,Tick,1049,1004,45,-45,149700,150200,19060,-43560,-57060,OK
189.313,TraderOne,Tick,1049,1004,45,-45,149700,150200,19060,-43560,-57060,OK
189.531,TraderOne,Tick,1059,1004,55,-45,150000,150200,18910,-1543410,-52410,OK
189.781,TraderOne,Tick,1059,1004,55,-55,150000,150200,18910,-40410,-51410,OK
189.969,TraderOne,Tick,1059,1004,55,-55,150000,150200,18910,-40410,-51410,OK
190.203,TraderOne,Tick,1059,1004,55,-55,150000,150300,18910,-40410,-56910,OK
190.516,TraderOne,Tick,1059,1004,55,-55,150000,150300,18910,-40410,-56910,OK
190.703,TraderOne,Tick,1059,1004,55,-55,150000,150300,18910,-40410,-56910,OK
191.031,TraderOne,Tick,1059,1004,55,-55,149500,150300,18910,-40410,-56910,OK
191.25,TraderOne,Tick,1059,1004,55,-55,149500,150400,18910,-40410,-56910,OK
191.547,TraderOne,Tick,1069,1004,65,-65,150000,150700,19210,-34710,-54210,OK
191.719,TraderOne,Tick,1069,1004,65,-65,150000,150800,19210,-34710,-54210,OK
191.938,TraderOne,Tick,1069,1014,55,-55,150200,150800,19510,-41010,-57510,OK
192.234,TraderOne,Tick,1069,1014,55,-55,150200,150700,19510,-41010,-57510,OK
192.5,TraderOne,Tick,1069,1014,55,-55,150200,150700,19510,-41010,-57510,OK
192.781,TraderOne,Tick,1079,1014,65,-65,150300,150700,19810,-37310,-56810,OK
193.063,TraderOne,Tick,1079,1014,65,-65,150200,150500,19810,-37310,-56810,OK
193.234,TraderOne,Tick,1079,1024,55,-55,150200,150500,20110,-42610,-59110,OK
193.516,TraderOne,Tick,1079,1034,45,-45,150000,150500,20410,-47910,-61410,OK
193.766,TraderOne,Tick,1079,1034,45,-45,150000,150500,20410,-47910,-61410,OK
194.0,TraderOne,Tick,1079,1034,45,-45,150000,150500,20410,-47910,-61410,OK
194.219,TraderOne,Tick,1079,1044,35,-35,150100,150500,20260,-55760,-66260,OK
194.531,TraderOne,Tick,1079,1044,35,-35,150100,150500,20260,-55760,-66260,OK
194.703,TraderOne,Tick,1079,1044,35,-35,150100,150500,20260,-55760,-66260,OK
195.031,TraderOne,Tick,1079,1044,35,-35,150100,150600,20260,-55760,-66260,OK
195.25,TraderOne,Tick,1079,1044,35,-35,150100,150600,20260,-55760,-66260,OK
195.516,TraderOne,Tick,1079,1044,35,-35,150100,150600,20260,-55760,-66260,OK
195.719,TraderOne,Tick,1079,1044,35,-35,150100,150600,20260,-55760,-66260,OK
196.031,TraderOne,Tick,1079,1044,35,-35,150100,150600,20260,-55760,-66260,OK
196.234,TraderOne,Tick,1079,1044,35,-35,150100,150600,20260,-55760,-66260,OK
196.5,TraderOne,Tick,1089,1044,45,-45,149800,150600,20110,-52610,-66110,OK
196.703,TraderOne,Tick,1089,1044,45,-45,149800,150100,20110,-52610,-66110,OK
197.047,TraderOne,Tick,1089,1044,45,-45,149800,150000,20110,-52610,-61610,OK
197.313,TraderOne,Tick,1089,1044,45,-45,149800,150000,20110,-52610,-61610,OK
197.5,TraderOne,Tick,1089,1054,35,-35,149500,150000,20409,-56909,-67409,OK
197.719,TraderOne,Tick,1089,1054,35,-35,149500,149800,20409,-56909,-67409,OK
198.016,TraderOne,Tick,1089,1054,35,-35,149500,149700,20409,-56909,-63909,OK
198.297,TraderOne,Tick,1089,1064,25,-25,149500,149700,20708,-60208,-65208,OK
198.547,TraderOne,Tick,1089,1074,15,-15,149500,149500,21007,-62507,-62507,OK
198.75,TraderOne,Tick,1089,1084,5,-5,149500,149500,21306,-64806,-64806,OK
199.016,TraderOne,Tick,1089,1084,5,-5,149500,149500,21306,-64806,-64806,OK
199.203,TraderOne,Tick,1089,1084,5,-5,149500,149500,21306,-64806,-64806,OK
199.469,TraderOne,Tick,1089,1084,5,-5,149500,149500,21306,-64806,-64806,OK
199.797,TraderOne,Tick,1089,1084,5,-5,149500,149500,21306,-64806,-64806,OK
200.0,TraderOne,Tick,1089,1084,5,-5,149500,149500,21306,-64806,-64806,OK
200.234,TraderOne,Tick,1089,1084,5,-5,149500,149600,21306,-64806,-65306,OK
200.531,TraderOne,Tick,1089,1088,1,-1,149700,149600,21246,-64746,-64646,OK
200.766,TraderOne,Tick,1089,1088,1,-1,149700,149600,21246,-64746,-64646,OK
201.0,TraderOne,Tick,1089,1088,1,-1,149700,149600,21246,-64746,-64646,OK
201.266,TraderOne,Tick,1089,1098,-9,9,149900,149600,21096,-64596,-66396,OK
201.516,TraderOne,Tick,1089,1098,-9,9,149900,149800,21096,-64596,-65496,OK
201.734,TraderOne,Tick,1098,1098,0,0,149900,150000,21366,-65766,-65766,OK
202.016,TraderOne,Tick,1108,1098,10,-10,149300,150000,21216,-65616,-68616,OK
202.203,TraderOne,Tick,1108,1098,10,-10,149300,150200,21216,-65616,-68616,OK
202.469,TraderOne,Tick,1108,1098,10,-10,149300,150200,21216,-65616,-68616,OK
202.781,TraderOne,Tick,1108,1098,10,-10,149300,150600,21216,-65616,-68616,OK
203.047,TraderOne,Tick,1118,1098,20,-20,150500,150600,21517,-64917,-66917,OK
203.313,TraderOne,Tick,1118,1098,20,-20,150500,150600,21517,-64917,-66917,OK
203.5,TraderOne,Tick,1118,1098,20,-20,150500,150600,21517,-64917,-66917,OK
203.766,TraderOne,Tick,1118,1098,20,-20,150500,150600,21517,-64917,-66917,OK
204.016,TraderOne,Tick,1128,1098,30,-20,150300,150600,21367,-1567767,-70767,OK
204.203,TraderOne,Tick,1128,1098,30,-30,150300,150600,21367,-63767,-72767,OK
204.484,TraderOne,Tick,1128,1098,30,-30,150300,150600,21367,-63767,-72767,OK
204.797,TraderOne,Tick,1128,1098,30,-30,150300,150600,21367,-63767,-72767,OK
205.047,TraderOne,Tick,1137,1098,39,-39,149900,150100,21232,-62732,-70532,OK
205.281,TraderOne,Tick,1137,1108,29,-29,149700,149700,21531,-65031,-65031,OK
205.547,TraderOne,Tick,1137,1118,19,-19,150400,149700,21381,-66881,-63081,OK
205.734,TraderOne,Tick,1137,1118,19,-19,150400,149700,21381,-66881,-63081,OK
206.031,TraderOne,Tick,1137,1128,9,-19,150300,149800,21231,1430269,-65031,OK
206.234,TraderOne,Tick,1137,1128,9,-9,150300,149800,21231,-68731,-66031,OK
206.453,TraderOne,Tick,1137,1128,9,-9,150300,149800,21231,-68731,-66031,OK
206.781,TraderOne,Tick,1137,1128,9,-9,150300,149800,21231,-68731,-66031,OK
207.047,TraderOne,Tick,1137,1128,9,-9,150300,149800,21231,-68731,-66031,OK
207.219,TraderOne,Tick,1137,1128,9,-9,150300,149800,21231,-68731,-66031,OK
207.547,TraderOne,Tick,1137,1128,9,-9,150300,149800,21231,-68731,-66031,OK
207.734,TraderOne,Tick,1137,1128,9,-9,150300,149800,21231,-68731,-66031,OK
207.953,TraderOne,Tick,1137,1128,9,-9,150300,149800,21231,-68731,-66031,OK
208.203,TraderOne,Tick,1147,1128,19,-19,149200,149800,21081,-68581,-74281,OK
208.516,TraderOne,Tick,1147,1138,9,-19,149800,149800,20931,1428569,-69431,OK
208.75,TraderOne,Tick,1147,1138,9,-9,149800,149800,20931,-69431,-69431,OK
208.969,TraderOne,Tick,1147,1138,9,-9,149800,149800,20931,-69431,-69431,OK
209.25,TraderOne,Tick,1147,1138,9,-9,149800,149800,20931,-69431,-69431,OK
209.516,TraderOne,Tick,1147,1138,9,-9,149800,149800,20931,-69431,-69431,OK
209.766,TraderOne,Tick,1147,1148,-1,1,150300,149800,20781,-69281,-69581,OK
209.953,TraderOne,Tick,1147,1148,-1,1,150300,149800,20781,-69281,-69581,OK
210.266,TraderOne,Tick,1147,1148,-1,1,150300,149800,20781,-69281,-69581,OK
210.453,TraderOne,Tick,1147,1148,-1,1,150300,149800,20781,-69281,-69581,OK
210.766,TraderOne,Tick,1147,1148,-1,1,150300,149800,20781,-69281,-69581,OK
211.0,TraderOne,Tick,1147,1158,-11,11,150400,149900,20631,-68131,-71431,OK
211.266,TraderOne,Tick,1147,1167,-20,20,150200,149900,20901,-65701,-71701,OK
211.547,TraderOne,Tick,1147,1167,-20,20,150200,149900,20901,-65701,-71701,OK
211.75,TraderOne,Tick,1157,1167,-10,10,149800,149600,20751,-69551,-71551,OK
212.031,TraderOne,Tick,1167,1167,0,0,149100,149600,20601,-70401,-70401,OK
212.203,TraderOne,Tick,1167,1167,0,0,149100,149700,20601,-70401,-70401,OK
212.484,TraderOne,Tick,1167,1167,0,0,149100,149700,20601,-70401,-70401,OK
212.797,TraderOne,Tick,1167,1177,-10,10,150200,149700,20451,-68251,-70251,OK
212.984,TraderOne,Tick,1167,1177,-10,10,150200,149700,20451,-68251,-70251,OK
213.297,TraderOne,Tick,1167,1177,-10,10,150200,149300,20451,-68251,-70251,OK
213.516,TraderOne,Tick,1167,1177,-10,10,150200,149300,20451,-68251,-70251,OK
213.703,TraderOne,Tick,1167,1177,-10,10,150200,149300,20451,-68251,-70251,OK
214.0,TraderOne,Tick,1167,1177,-10,10,150200,149300,20451,-68251,-70251,OK
214.297,TraderOne,Tick,1167,1177,-10,10,150200,149300,20451,-68251,-70251,OK
214.469,TraderOne,Tick,1167,1177,-10,10,150200,149300,20451,-68251,-70251,OK
214.781,TraderOne,Tick,1167,1177,-10,10,150200,149600,20451,-68251,-70251,OK
215.047,TraderOne,Tick,1167,1177,-10,10,150200,149600,20451,-68251,-70251,OK
215.203,TraderOne,Tick,1167,1177,-10,10,150200,149600,20451,-68251,-70251,OK
215.547,TraderOne,Tick,1167,1177,-10,10,150200,149600,20451,-68251,-70251,OK
215.781,TraderOne,Tick,1167,1177,-10,10,150200,149600,20451,-68251,-70251,OK
216.016,TraderOne,Tick,1173,1177,-4,4,149300,149600,20361,-68161,-67361,OK
216.25,TraderOne,Tick,1173,1177,-4,4,149300,149400,20361,-68161,-67761,OK
216.547,TraderOne,Tick,1173,1177,-4,4,149300,149700,20361,-68161,-67361,OK
216.797,TraderOne,Tick,1183,1177,6,-6,149700,149700,20660,-67460,-67460,OK
217.016,TraderOne,Tick,1193,1177,16,-16,149900,150000,20645,-66845,-68445,OK
217.219,TraderOne,Tick,1203,1177,26,-26,149500,150000,20944,-63144,-70944,OK
217.469,TraderOne,Tick,1213,1177,36,-36,149500,150100,21243,-59443,-70243,OK
217.734,TraderOne,Tick,1213,1177,36,-36,149500,150100,21243,-59443,-70243,OK
218.0,TraderOne,Tick,1213,1177,36,-36,149500,149900,21243,-59443,-70243,OK
218.234,TraderOne,Tick,1213,1177,36,-36,149500,149900,21243,-59443,-70243,OK
218.5,TraderOne,Tick,1213,1177,36,-36,149500,149900,21243,-59443,-70243,OK
218.703,TraderOne,Tick,1213,1177,36,-36,149500,149900,21243,-59443,-70243,OK
219.031,TraderOne,Tick,1213,1187,26,-36,150500,149900,21093,1437707,-53493,OK
219.203,TraderOne,Tick,1213,1187,26,-26,150500,149900,21093,-62293,-54493,OK
219.5,TraderOne,Tick,1213,1197,16,-16,150400,149900,20943,-65143,-60343,OK
219.781,TraderOne,Tick,1213,1197,16,-16,150400,149900,20943,-65143,-60343,OK
219.984,TraderOne,Tick,1213,1207,6,-6,150500,149900,20793,-65993,-64193,OK
220.25,TraderOne,Tick,1213,1207,6,-6,150500,149900,20793,-65993,-64193,OK
220.516,TraderOne,Tick,1213,1207,6,-6,150500,149900,20793,-65993,-64193,OK
220.766,TraderOne,Tick,1213,1207,6,-6,150500,149900,20793,-65993,-64193,OK
221.0,TraderOne,Tick,1213,1217,-4,4,150500,150000,20643,-65843,-67043,OK
221.266,TraderOne,Tick,1213,1217,-4,4,150500,150000,20643,-65843,-67043,OK
221.5,TraderOne,Tick,1213,1217,-4,4,150500,150100,20643,-65843,-67043,OK
221.719,TraderOne,Tick,1213,1217,-4,4,150500,150100,20643,-65843,-67043,OK
221.969,TraderOne,Tick,1213,1217,-4,4,150500,150100,20643,-65843,-67043,OK
222.266,TraderOne,Tick,1213,1217,-4,4,150500,150100,20643,-65843,-67043,OK
222.5,TraderOne,Tick,1213,1217,-4,4,150500,150100,20643,-65843,-67043,OK
222.75,TraderOne,Tick,1223,1217,6,-6,149500,150100,20493,-66693,-68493,OK
223.047,TraderOne,Tick,1223,1217,6,-6,149500,150000,20493,-66693,-68493,OK
223.219,TraderOne,Tick,1223,1227,-4,4,150100,150000,20793,-66993,-67393,OK
223.484,TraderOne,Tick,1223,1227,-4,4,150100,150000,20793,-66993,-67393,OK
223.766,TraderOne,Tick,1223,1237,-14,14,150300,150000,20643,-65843,-70043,OK
224.063,TraderOne,Tick,1223,1247,-24,24,150400,150000,20944,-64144,-71344,OK
224.266,TraderOne,Tick,1223,1253,-30,30,150400,150000,21124,-61924,-70924,OK
224.5,TraderOne,Tick,1223,1253,-30,30,150400,150000,21124,-61924,-70924,OK
224.781,TraderOne,Tick,1223,1253,-30,30,150400,149800,21124,-61924,-70924,OK
225.016,TraderOne,Tick,1223,1263,-40,40,150100,149400,21424,-56224,-64224,OK
225.281,TraderOne,Tick,1223,1263,-40,40,150100,149500,21424,-56224,-64224,OK
225.5,TraderOne,Tick,1223,1263,-40,40,150100,149500,21424,-56224,-64224,OK
225.734,TraderOne,Tick,1223,1263,-40,40,150100,149500,21424,-56224,-64224,OK
226.016,TraderOne,Tick,1233,1263,-30,40,149300,149500,21274,-1555074,-54074,OK
226.281,TraderOne,Tick,1233,1263,-30,30,149300,149500,21274,-60074,-54074,OK
226.5,TraderOne,Tick,1233,1263,-30,30,149300,149500,21274,-60074,-54074,OK
226.766,TraderOne,Tick,1233,1273,-40,40,150300,149500,21124,-57924,-65924,OK
227.063,TraderOne,Tick,1233,1273,-40,40,150300,149500,21124,-57924,-65924,OK
227.297,TraderOne,Tick,1233,1273,-40,40,150300,149500,21124,-57924,-65924,OK
227.5,TraderOne,Tick,1233,1273,-40,40,150300,150200,21124,-57924,-61924,OK
227.781,TraderOne,Tick,1243,1273,-30,30,150600,150600,21425,-61725,-61725,OK
227.984,TraderOne,Tick,1253,1273,-20,20,150600,150800,21726,-60026,-56026,OK
228.266,TraderOne,Tick,1263,1273,-10,10,150600,150600,22027,-59327,-59327,OK
228.516,TraderOne,Tick,1273,1273,0,0,150600,150600,22328,-58628,-58628,OK
228.703,TraderOne,Tick,1283,1273,10,-10,150600,150600,22629,-58929,-58929,OK
229.063,TraderOne,Tick,1287,1273,14,-14,150500,150600,22569,-58069,-59469,OK
229.297,TraderOne,Tick,1297,1273,24,-24,150600,150600,22870,-57370,-57370,OK
229.469,TraderOne,Tick,1297,1273,24,-24,150600,150600,22870,-57370,-57370,OK
229.734,TraderOne,Tick,1297,1273,24,-24,150600,150600,22870,-57370,-57370,OK
230.0,TraderOne,Tick,1297,1273,24,-24,150600,150600,22870,-57370,-57370,OK
230.281,TraderOne,Tick,1297,1273,24,-24,150600,150700,22870,-57370,-59770,OK
230.547,TraderOne,Tick,1297,1273,24,-24,150600,150700,22870,-57370,-59770,OK
230.766,TraderOne,Tick,1297,1273,24,-24,150600,150700,22870,-57370,-59770,OK
231.016,TraderOne,Tick,1297,1273,24,-24,150600,150700,22870,-57370,-59770,OK
231.219,TraderOne,Tick,1297,1273,24,-24,150600,150700,22870,-57370,-59770,OK
231.547,TraderOne,Tick,1297,1273,24,-24,150600,150700,22870,-57370,-59770,OK
231.75,TraderOne,Tick,1297,1273,24,-24,150600,150700,22870,-57370,-59770,OK
232.047,TraderOne,Tick,1297,1273,24,-24,150600,150700,22870,-57370,-59770,OK
232.313,TraderOne,Tick,1297,1273,24,-24,150600,150700,22870,-57370,-59770,OK
232.547,TraderOne,Tick,1297,1273,24,-24,150600,150700,22870,-57370,-59770,OK
232.719,TraderOne,Tick,1297,1273,24,-24,150600,150700,22870,-57370,-59770,OK
233.063,TraderOne,Tick,1297,1273,24,-24,150600,150700,22870,-57370,-59770,OK
233.219,TraderOne,Tick,1307,1273,34,-34,150700,151100,23171,-54671,-64871,OK
233.516,TraderOne,Tick,1317,1273,44,-44,150700,151100,23472,-51972,-65172,OK
233.703,TraderOne,Tick,1317,1273,44,-44,150700,151100,23472,-51972,-65172,OK
234.047,TraderOne,Tick,1317,1273,44,-44,150700,151100,23472,-51972,-65172,OK
234.234,TraderOne,Tick,1317,1273,44,-44,150700,151100,23472,-51972,-65172,OK
234.469,TraderOne,Tick,1317,1273,44,-44,150700,151200,23472,-51972,-65172,OK
234.781,TraderOne,Tick,1317,1273,44,-44,150700,151200,23472,-51972,-65172,OK
235.063,TraderOne,Tick,1327,1273,54,-54,150800,151200,23774,-47274,-63474,OK
235.234,TraderOne,Tick,1327,1283,44,-44,151000,151500,24076,-54576,-67776,OK
235.453,TraderOne,Tick,1328,1283,45,-45,151100,151500,24106,-54206,-67706,OK
235.719,TraderOne,Tick,1328,1283,45,-45,151100,151600,24106,-54206,-67706,OK
236.016,TraderOne,Tick,1338,1283,55,-55,151200,151600,24408,-50508,-67008,OK
236.219,TraderOne,Tick,1338,1283,55,-55,151200,151600,24408,-50508,-67008,OK
236.453,TraderOne,Tick,1338,1283,55,-55,151000,151600,24408,-50508,-67008,OK
236.797,TraderOne,Tick,1338,1293,45,-45,151300,151600,24257,-54357,-67857,OK
237.0,TraderOne,Tick,1348,1293,55,-55,151000,151600,24106,-50206,-66706,OK
237.281,TraderOne,Tick,1348,1293,55,-55,151000,151700,24106,-50206,-66706,OK
237.547,TraderOne,Tick,1348,1293,55,-55,151000,151700,24106,-50206,-66706,OK
237.766,TraderOne,Tick,1348,1293,55,-55,151000,151700,24106,-50206,-66706,OK
237.969,TraderOne,Tick,1348,1293,55,-55,151000,151700,24106,-50206,-66706,OK
238.234,TraderOne,Tick,1348,1293,55,-55,151000,151700,24106,-50206,-66706,OK
238.453,TraderOne,Tick,1348,1293,55,-55,151000,151700,24106,-50206,-66706,OK
238.719,TraderOne,Tick,1348,1293,55,-55,151000,151700,24106,-50206,-66706,OK
239.047,TraderOne,Tick,1348,1293,55,-55,151000,151700,24106,-50206,-66706,OK
239.281,TraderOne,Tick,1348,1293,55,-55,151000,151500,24106,-50206,-66706,OK
239.547,TraderOne,Tick,1348,1303,45,-45,151300,151500,23955,-55055,-64055,OK
239.719,TraderOne,Tick,1348,1303,45,-45,151300,151600,23955,-55055,-68555,OK
239.953,TraderOne,Tick,1348,1303,45,-45,151300,151500,23955,-55055,-64055,OK
240.266,TraderOne,Tick,1348,1303,45,-45,151300,151400,23955,-55055,-59555,OK
240.531,TraderOne,Tick,1348,1313,35,-35,151400,151400,23804,-58904,-58904,OK
240.781,TraderOne,Tick,1348,1313,35,-35,151400,151500,23804,-58904,-62404,OK
240.984,TraderOne,Tick,1348,1313,35,-35,151400,151500,23804,-58904,-62404,OK
241.234,TraderOne,Tick,1348,1313,35,-35,151400,151500,23804,-58904,-62404,OK
241.547,TraderOne,Tick,1348,1313,35,-35,151400,151500,23804,-58904,-62404,OK
241.781,TraderOne,Tick,1348,1313,35,-35,151400,151500,23804,-58904,-62404,OK
242.047,TraderOne,Tick,1368,1313,55,-55,150900,151300,23502,-53602,-70102,OK
242.25,TraderOne,Tick,1368,1313,55,-55,150800,151300,23502,-53602,-70102,OK
242.469,TraderOne,Tick,1368,1323,45,-45,150800,151300,23804,-58904,-72404,OK
242.734,TraderOne,Tick,1368,1323,45,-45,150800,151300,23804,-58904,-72404,OK
243.047,TraderOne,Tick,1368,1323,45,-45,150800,151300,23804,-58904,-72404,OK
243.234,TraderOne,Tick,1368,1323,45,-45,150800,151300,23804,-58904,-72404,OK
243.547,TraderOne,Tick,1378,1323,55,-55,150800,151300,23653,-54753,-71253,OK
243.734,TraderOne,Tick,1378,1323,55,-55,150800,151300,23653,-54753,-71253,OK
244.016,TraderOne,Tick,1378,1323,55,-55,150800,151500,23653,-54753,-71253,OK
244.25,TraderOne,Tick,1378,1323,55,-55,150800,151500,23653,-54753,-71253,OK
244.516,TraderOne,Tick,1378,1323,55,-55,150800,151500,23653,-54753,-71253,OK
244.703,TraderOne,Tick,1378,1323,55,-55,150800,151500,23653,-54753,-71253,OK
244.984,TraderOne,Tick,1378,1323,55,-55,150800,151500,23653,-54753,-71253,OK
245.266,TraderOne,Tick,1378,1323,55,-55,150800,151400,23653,-54753,-71253,OK
245.531,TraderOne,Tick,1378,1323,55,-55,150800,151600,23653,-54753,-71253,OK
245.703,TraderOne,Tick,1378,1333,45,-45,151400,151800,23502,-62602,-76102,OK
246.031,TraderOne,Tick,1378,1333,45,-45,151400,151800,23502,-62602,-76102,OK
246.219,TraderOne,Tick,1378,1333,45,-45,151400,151800,23502,-62602,-76102,OK
246.516,TraderOne,Tick,1378,1333,45,-45,151400,151800,23502,-62602,-76102,OK
246.734,TraderOne,Tick,1378,1333,45,-45,151400,151800,23502,-62602,-76102,OK
247.047,TraderOne,Tick,1388,1333,55,-55,151400,152100,23805,-58905,-75405,OK
247.219,TraderOne,Tick,1398,1333,65,-65,151700,152100,24108,-52808,-72308,OK
247.453,TraderOne,Tick,1398,1333,65,-65,151700,152100,24108,-52808,-72308,OK
247.734,TraderOne,Tick,1398,1333,65,-65,151400,152100,24108,-52808,-72308,OK
248.031,TraderOne,Tick,1398,1343,55,-65,151500,152100,23956,1462344,-75156,OK
248.25,TraderOne,Tick,1398,1343,55,-55,151500,152100,23956,-59656,-76156,OK
248.453,TraderOne,Tick,1398,1343,55,-55,151500,152100,23956,-59656,-76156,OK
248.734,TraderOne,Tick,1398,1343,55,-55,151500,152100,23956,-59656,-76156,OK
248.969,TraderOne,Tick,1398,1353,45,-45,151800,152100,23804,-64504,-78004,OK
249.234,TraderOne,Tick,1408,1363,45,-45,152000,152700,23956,-69656,-83156,OK
249.484,TraderOne,Tick,1418,1363,55,-55,152100,152900,24260,-62960,-79460,OK
249.766,TraderOne,Tick,1428,1363,65,-65,152400,152600,24564,-55264,-68264,OK
250.047,TraderOne,Tick,1428,1373,55,-55,152400,152700,24869,-58569,-75069,OK
250.297,TraderOne,Tick,1428,1373,55,-55,152400,152700,24869,-58569,-75069,OK
250.5,TraderOne,Tick,1428,1383,45,-45,152600,152700,24717,-63417,-67917,OK
250.766,TraderOne,Tick,1428,1383,45,-45,152600,152700,24717,-63417,-67917,OK
250.984,TraderOne,Tick,1428,1383,45,-45,152600,152700,24717,-63417,-67917,OK
251.281,TraderOne,Tick,1438,1383,55,-55,152000,152500,24565,-59265,-75765,OK
251.563,TraderOne,Tick,1438,1383,55,-55,152000,152600,24565,-59265,-75765,OK
251.766,TraderOne,Tick,1438,1383,55,-55,152000,152500,24565,-59265,-75765,OK
252.031,TraderOne,Tick,1438,1383,55,-55,152000,152500,24565,-59265,-75765,OK
252.234,TraderOne,Tick,1438,1383,55,-55,152000,152500,24565,-59265,-75765,OK
252.547,TraderOne,Tick,1438,1383,55,-55,152000,152500,24565,-59265,-75765,OK
252.766,TraderOne,Tick,1438,1393,45,-45,152600,152500,24413,-64113,-59613,OK
252.953,TraderOne,Tick,1438,1393,45,-45,152600,152500,24413,-64113,-59613,OK
253.219,TraderOne,Tick,1438,1393,45,-45,152600,152500,24413,-64113,-59613,OK
253.516,TraderOne,Tick,1438,1393,45,-45,152600,152500,24413,-64113,-59613,OK
253.766,TraderOne,Tick,1438,1393,45,-45,152600,152500,24413,-64113,-59613,OK
254.047,TraderOne,Tick,1438,1393,45,-45,152600,152600,24413,-64113,-64113,OK
254.313,TraderOne,Tick,1438,1393,45,-45,152600,152500,24413,-64113,-59613,OK
254.531,TraderOne,Tick,1438,1403,35,-35,152200,152500,24261,-67961,-78461,OK
254.766,TraderOne,Tick,1438,1403,35,-35,152200,152500,24261,-67961,-78461,OK
255.047,TraderOne,Tick,1438,1403,35,-35,152200,152500,24261,-67961,-78461,OK
255.297,TraderOne,Tick,1438,1403,35,-35,152200,152500,24261,-67961,-78461,OK
255.516,TraderOne,Tick,1438,1403,35,-35,152200,152500,24261,-67961,-78461,OK
255.781,TraderOne,Tick,1438,1403,35,-35,152200,152200,24261,-67961,-67961,OK
255.984,TraderOne,Tick,1438,1403,35,-35,152200,152200,24261,-67961,-67961,OK
256.266,TraderOne,Tick,1438,1403,35,-35,152200,152200,24261,-67961,-67961,OK
256.484,TraderOne,Tick,1438,1403,35,-35,152200,152000,24261,-67961,-60961,OK
256.719,TraderOne,Tick,1438,1403,35,-35,152200,152000,24261,-67961,-60961,OK
257.063,TraderOne,Tick,1438,1403,35,-35,152200,152000,24261,-67961,-60961,OK
257.281,TraderOne,Tick,1448,1403,45,-45,151400,152000,24109,-64809,-78309,OK
257.5,TraderOne,Tick,1448,1403,45,-45,151400,152000,24109,-64809,-78309,OK
257.734,TraderOne,Tick,1448,1403,45,-45,151400,152000,24109,-64809,-78309,OK
258.016,TraderOne,Tick,1448,1403,45,-45,151400,152000,24109,-64809,-78309,OK
258.266,TraderOne,Tick,1448,1413,35,-35,151700,151900,23957,-68657,-75657,OK
258.5,TraderOne,Tick,1448,1413,35,-35,151700,151800,23957,-68657,-72157,OK
258.797,TraderOne,Tick,1448,1413,35,-35,151700,151700,23957,-68657,-68657,OK
259.0,TraderOne,Tick,1448,1423,25,-25,151700,151700,23805,-71505,-71505,OK
259.266,TraderOne,Tick,1448,1423,25,-25,151700,151600,23805,-71505,-69005,OK
259.547,TraderOne,Tick,1448,1423,25,-25,151700,151600,23805,-71505,-69005,OK
259.734,TraderOne,Tick,1448,1423,25,-25,151700,151600,23805,-71505,-69005,OK
260.031,TraderOne,Tick,1448,1423,25,-25,151700,151600,23805,-71505,-69005,OK
260.266,TraderOne,Tick,1458,1423,35,-35,151300,151600,23654,-69354,-79854,OK
260.547,TraderOne,Tick,1458,1423,35,-35,151300,151600,23654,-69354,-79854,OK
260.734,TraderOne,Tick,1458,1433,25,-25,151300,151800,23957,-73657,-81157,OK
261.047,TraderOne,Tick,1458,1433,25,-25,151300,151800,23957,-73657,-81157,OK
261.266,TraderOne,Tick,1458,1433,25,-25,151300,151800,23957,-73657,-81157,OK
261.563,TraderOne,Tick,1458,1433,25,-25,151300,151800,23957,-73657,-81157,OK
261.766,TraderOne,Tick,1458,1443,15,-15,152000,151800,23805,-75505,-72505,OK
262.047,TraderOne,Tick,1468,1443,25,-25,151600,151800,23653,-74353,-79353,OK
262.203,TraderOne,Tick,1478,1443,35,-35,151600,151800,23956,-72656,-79656,OK
262.516,TraderOne,Tick,1478,1443,35,-35,151600,151800,23956,-72656,-79656,OK
262.703,TraderOne,Tick,1478,1443,35,-35,151600,151800,23956,-72656,-79656,OK
263.0,TraderOne,Tick,1478,1443,35,-35,151600,151800,23956,-72656,-79656,OK
263.297,TraderOne,Tick,1488,1443,45,-45,151600,152200,24259,-68959,-82459,OK
263.516,TraderOne,Tick,1497,1443,54,-54,151600,152200,24532,-65632,-81832,OK
263.703,TraderOne,Tick,1497,1453,44,-44,151500,152200,24835,-70935,-84135,OK
263.969,TraderOne,Tick,1497,1453,44,-44,151500,152200,24835,-70935,-84135,OK
264.219,TraderOne,Tick,1497,1453,44,-44,151500,152200,24835,-70935,-84135,OK
264.516,TraderOne,Tick,1497,1453,44,-44,151500,152200,24835,-70935,-84135,OK
264.719,TraderOne,Tick,1497,1453,44,-44,151500,151800,24835,-70935,-84135,OK
265.0,TraderOne,Tick,1497,1453,44,-44,151500,151800,24835,-70935,-84135,OK
265.25,TraderOne,Tick,1497,1453,44,-44,151500,151800,24835,-70935,-84135,OK
265.516,TraderOne,Tick,1497,1453,44,-44,151500,151800,24835,-70935,-84135,OK
265.766,TraderOne,Tick,1497,1453,44,-44,151500,151800,24835,-70935,-84135,OK
266.047,TraderOne,Tick,1497,1463,34,-34,152100,151800,24683,-76783,-66583,OK
266.25,TraderOne,Tick,1497,1463,34,-34,152100,151800,24683,-76783,-66583,OK
266.484,TraderOne,Tick,1497,1469,28,-28,151800,151800,24592,-78492,-78492,OK
266.719,TraderOne,Tick,1497,1469,28,-28,151800,151800,24592,-78492,-78492,OK
266.969,TraderOne,Tick,1497,1469,28,-28,151800,152200,24592,-78492,-86892,OK
267.266,TraderOne,Tick,1497,1469,28,-28,151800,152200,24592,-78492,-86892,OK
267.547,TraderOne,Tick,1497,1469,28,-28,152100,152200,24592,-78492,-81292,OK
267.734,TraderOne,Tick,1497,1469,28,-28,152100,152200,24592,-78492,-81292,OK
267.984,TraderOne,Tick,1497,1469,28,-28,152100,152200,24592,-78492,-81292,OK
268.281,TraderOne,Tick,1507,1469,38,-38,152200,152200,24896,-75796,-75796,OK
268.516,TraderOne,Tick,1510,1469,41,-41,152200,152200,24987,-74987,-74987,OK
268.813,TraderOne,Tick,1510,1469,41,-41,152200,152600,24987,-74987,-87287,OK
268.969,TraderOne,Tick,1510,1469,41,-41,152200,152600,24987,-74987,-87287,OK
269.281,TraderOne,Tick,1510,1469,41,-41,152200,152600,24987,-74987,-87287,OK
269.516,TraderOne,Tick,1510,1469,41,-41,152200,153000,24987,-74987,-87287,OK
269.766,TraderOne,Tick,1520,1469,51,-51,152300,153000,25292,-72292,-87592,OK
270.016,TraderOne,Tick,1530,1469,61,-61,152100,153000,25140,-67140,-85440,OK
270.219,TraderOne,Tick,1530,1469,61,-61,152100,153000,25140,-67140,-85440,OK
270.484,TraderOne,Tick,1530,1469,61,-61,152100,152900,25140,-67140,-85440,OK
270.797,TraderOne,Tick,1530,1469,61,-61,152100,152900,25140,-67140,-85440,OK
271.031,TraderOne,Tick,1535,1479,56,-56,152400,153000,25597,-71597,-88397,OK
271.234,TraderOne,Tick,1535,1479,56,-56,152400,153000,25597,-71597,-88397,OK
271.484,TraderOne,Tick,1535,1489,46,-46,152700,153300,25444,-78444,-92244,OK
271.781,TraderOne,Tick,1545,1499,46,-46,153000,153600,25597,-81597,-95397,OK
272.031,TraderOne,Tick,1555,1499,56,-46,153100,153600,25444,-1613444,-94244,OK
272.234,TraderOne,Tick,1555,1499,56,-56,153100,153600,25444,-76444,-93244,OK
272.531,TraderOne,Tick,1555,1509,46,-46,153600,153600,25750,-81750,-81750,OK
272.766,TraderOne,Tick,1565,1509,56,-56,152800,153600,25597,-78597,-95397,OK
272.984,TraderOne,Tick,1565,1509,56,-56,152800,153600,25597,-78597,-95397,OK
273.297,TraderOne,Tick,1565,1509,56,-56,152800,153600,25597,-78597,-95397,OK
273.547,TraderOne,Tick,1575,1509,66,-66,152600,153600,25444,-73444,-93244,OK
273.781,TraderOne,Tick,1575,1509,66,-66,152600,153600,25444,-73444,-93244,OK
274.016,TraderOne,Tick,1575,1519,56,-56,153800,153600,25749,-78749,-67549,OK
274.297,TraderOne,Tick,1575,1519,56,-56,153800,153600,25749,-78749,-67549,OK
274.5,TraderOne,Tick,1575,1519,56,-56,153800,152900,25749,-78749,-61949,OK
274.719,TraderOne,Tick,1575,1529,46,-46,152500,152900,26054,-83054,-96854,OK
274.984,TraderOne,Tick,1575,1539,36,-36,152500,152900,26359,-87359,-98159,OK
275.219,TraderOne,Tick,1585,1549,36,-26,152300,152700,26512,-1613512,-97312,OK
275.453,TraderOne,Tick,1585,1558,27,-36,152500,152700,26375,1287125,-92575,OK
275.797,TraderOne,Tick,1585,1558,27,-27,152500,152700,26375,-89875,-95275,OK
275.984,TraderOne,Tick,1585,1558,27,-27,152500,152700,26375,-89875,-95275,OK
276.234,TraderOne,Tick,1585,1558,27,-27,152500,153000,26375,-89875,-97975,OK
276.453,TraderOne,Tick,1585,1558,27,-27,152500,153100,26375,-89875,-97975,OK
276.797,TraderOne,Tick,1585,1558,27,-27,152500,153100,26375,-89875,-97975,OK
277.031,TraderOne,Tick,1595,1558,37,-37,152400,153100,26222,-89722,-100822,OK
277.297,TraderOne,Tick,1595,1558,37,-37,152400,153100,26222,-89722,-100822,OK
277.516,TraderOne,Tick,1595,1558,37,-37,152400,152900,26222,-89722,-100822,OK
277.797,TraderOne,Tick,1595,1558,37,-37,152400,152900,26222,-89722,-100822,OK
277.953,TraderOne,Tick,1595,1558,37,-37,152400,152900,26222,-89722,-100822,OK
278.234,TraderOne,Tick,1595,1558,37,-37,152400,152900,26222,-89722,-100822,OK
278.5,TraderOne,Tick,1595,1558,37,-37,152400,153000,26222,-89722,-100822,OK
278.734,TraderOne,Tick,1595,1568,27,-27,152800,153100,26069,-95569,-103669,OK
279.063,TraderOne,Tick,1595,1568,27,-27,152800,153200,26069,-95569,-103669,OK
279.25,TraderOne,Tick,1595,1568,27,-27,152800,153200,26069,-95569,-103669,OK
279.516,TraderOne,Tick,1595,1568,27,-27,152800,153200,26069,-95569,-103669,OK
279.75,TraderOne,Tick,1595,1568,27,-27,152800,153200,26069,-95569,-103669,OK
280.016,TraderOne,Tick,1595,1568,27,-27,152800,153200,26069,-95569,-103669,OK
280.281,TraderOne,Tick,1595,1568,27,-27,152800,153000,26069,-95569,-100969,OK
280.563,TraderOne,Tick,1595,1578,17,-17,152800,152800,26375,-95875,-95875,OK
280.797,TraderOne,Tick,1595,1588,7,-7,152800,152800,26681,-96181,-96181,OK
281.063,TraderOne,Tick,1595,1588,7,-7,152800,152600,26681,-96181,-94781,OK
281.25,TraderOne,Tick,1595,1598,-3,3,152800,152700,26987,-95487,-95787,OK
281.531,TraderOne,Tick,1595,1598,-3,3,152800,152700,26987,-95487,-95787,OK
281.781,TraderOne,Tick,1595,1598,-3,3,152800,152700,26987,-95487,-95787,OK
282.016,TraderOne,Tick,1595,1598,-3,3,152800,152700,26987,-95487,-95787,OK
282.266,TraderOne,Tick,1605,1598,7,-7,152300,152700,26834,-96334,-98434,OK
282.516,TraderOne,Tick,1605,1598,7,-7,152300,152700,26834,-96334,-98434,OK
282.766,TraderOne,Tick,1605,1598,7,-7,152300,152800,26834,-96334,-98434,OK
283.016,TraderOne,Tick,1605,1598,7,-7,152300,152800,26834,-96334,-98434,OK
283.266,TraderOne,Tick,1605,1598,7,-7,152300,152800,26834,-96334,-98434,OK
283.469,TraderOne,Tick,1605,1598,7,-7,152300,152800,26834,-96334,-98434,OK
283.703,TraderOne,Tick,1605,1598,7,-7,152300,152800,26834,-96334,-98434,OK
284.016,TraderOne,Tick,1615,1608,7,-17,153400,152800,26528,1432972,-92928,OK
284.203,TraderOne,Tick,1615,1608,7,-7,153400,152800,26528,-97028,-94928,OK
284.469,TraderOne,Tick,1615,1608,7,-7,153400,152800,26528,-97028,-94928,OK
284.719,TraderOne,Tick,1625,1608,17,-17,152400,152800,26375,-96875,-101975,OK
285.047,TraderOne,Tick,1625,1608,17,-17,152400,153100,26375,-96875,-101975,OK
285.25,TraderOne,Tick,1634,1608,26,-26,153100,153500,26237,-94037,-101837,OK
285.516,TraderOne,Tick,1634,1608,26,-26,153900,153500,26237,-94037,-86237,OK
285.734,TraderOne,Tick,1634,1608,26,-26,153900,153500,26237,-94037,-86237,OK
286.031,TraderOne,Tick,1634,1608,26,-26,153900,153800,26237,-94037,-91437,OK
286.266,TraderOne,Tick,1634,1608,26,-26,153900,153600,26237,-94037,-86237,OK
286.516,TraderOne,Tick,1634,1608,26,-26,153900,153600,26237,-94037,-86237,OK
286.781,TraderOne,Tick,1634,1608,26,-26,153900,153600,26237,-94037,-86237,OK
287.0,TraderOne,Tick,1634,1618,16,-16,153900,153600,26084,-95884,-91084,OK
287.266,TraderOne,Tick,1634,1618,16,-16,153900,153500,26084,-95884,-91084,OK
287.516,TraderOne,Tick,1639,1618,21,-21,153400,153600,26007,-95307,-99507,OK
287.719,TraderOne,Tick,1639,1618,21,-21,153400,153600,26007,-95307,-99507,OK
287.969,TraderOne,Tick,1639,1618,21,-21,153400,153600,26007,-95307,-99507,OK
288.266,TraderOne,Tick,1639,1618,21,-21,153400,153600,26007,-95307,-99507,OK
288.5,TraderOne,Tick,1639,1618,21,-21,153400,153400,26007,-95307,-95307,OK
288.75,TraderOne,Tick,1639,1618,21,-21,153400,153400,26007,-95307,-95307,OK
289.0,TraderOne,Tick,1639,1618,21,-21,153400,153400,26007,-95307,-95307,OK
289.266,TraderOne,Tick,1639,1618,21,-21,153400,153400,26007,-95307,-95307,OK
289.547,TraderOne,Tick,1639,1618,21,-21,153400,153400,26007,-95307,-95307,OK
289.766,TraderOne,Tick,1639,1628,11,-11,153300,153400,25854,-97154,-98254,OK
290.016,TraderOne,Tick,1639,1638,1,-1,153400,153400,26161,-98461,-98461,OK
290.203,TraderOne,Tick,1639,1638,1,-1,153400,153500,26161,-98461,-98561,OK
290.469,TraderOne,Tick,1643,1638,5,-5,153500,153500,26100,-98400,-98400,OK
290.766,TraderOne,Tick,1643,1638,5,-5,153400,153500,26100,-98400,-98900,OK
291.016,TraderOne,Tick,1653,1648,5,-5,153100,153500,25793,-98093,-99593,OK
291.266,TraderOne,Tick,1653,1648,5,-5,153100,153500,25793,-98093,-99593,OK
291.516,TraderOne,Tick,1653,1658,-5,5,153900,153500,25639,-97939,-99439,OK
291.734,TraderOne,Tick,1653,1658,-5,5,153900,153500,25639,-97939,-99439,OK
292.047,TraderOne,Tick,1653,1658,-5,5,153900,153500,25639,-97939,-99439,OK
292.266,TraderOne,Tick,1653,1658,-5,5,153900,153500,25639,-97939,-99439,OK
292.484,TraderOne,Tick,1653,1668,-15,15,153900,153500,25485,-96785,-101285,OK
292.703,TraderOne,Tick,1653,1678,-25,25,153900,153600,25793,-94093,-101593,OK
292.969,TraderOne,Tick,1653,1688,-35,35,153900,153600,26101,-91401,-101901,OK
293.234,TraderOne,Tick,1653,1688,-35,35,153900,153600,26101,-91401,-101901,OK
293.469,TraderOne,Tick,1653,1688,-35,35,153900,153400,26101,-91401,-101901,OK
293.703,TraderOne,Tick,1653,1688,-35,35,153900,153400,26101,-91401,-101901,OK
294.0,TraderOne,Tick,1653,1698,-45,45,153900,153400,26409,-87709,-101209,OK
294.234,TraderOne,Tick,1653,1698,-45,45,153900,153400,26409,-87709,-101209,OK
294.547,TraderOne,Tick,1653,1698,-45,45,154000,153400,26409,-87709,-101209,OK
294.766,TraderOne,Tick,1653,1698,-45,45,154000,153400,26409,-87709,-101209,OK
294.969,TraderOne,Tick,1653,1698,-45,45,154000,153500,26409,-87709,-101209,OK
295.266,TraderOne,Tick,1663,1698,-35,35,154000,153500,26717,-93017,-103517,OK
295.516,TraderOne,Tick,1668,1698,-30,30,153900,153500,26640,-94940,-103940,OK
295.766,TraderOne,Tick,1668,1698,-30,30,153900,153500,26640,-94940,-103940,OK
296.0,TraderOne,Tick,1668,1698,-30,30,153900,153500,26640,-94940,-103940,OK
296.203,TraderOne,Tick,1668,1698,-30,30,153900,153500,26640,-94940,-103940,OK
296.469,TraderOne,Tick,1668,1698,-30,30,153900,153500,26640,-94940,-103940,OK
296.719,TraderOne,Tick,1668,1708,-40,40,153800,153400,26948,-92248,-104248,OK
297.016,TraderOne,Tick,1668,1708,-40,40,153800,153400,26948,-92248,-104248,OK
297.297,TraderOne,Tick,1668,1718,-50,50,153800,153200,27256,-88556,-103556,OK
297.578,TraderOne,Tick,1668,1718,-50,50,153800,153300,27256,-88556,-103556,OK
297.797,TraderOne,Tick,1668,1718,-50,50,153800,153300,27256,-88556,-103556,OK
297.969,TraderOne,Tick,1678,1718,-40,40,153800,153500,27564,-92864,-104864,OK
298.234,TraderOne,Tick,1688,1718,-30,30,153100,153600,27410,-95710,-86710,OK
298.5,TraderOne,Tick,1698,1718,-20,20,153100,153600,27716,-91016,-85016,OK
298.734,TraderOne,Tick,1708,1718,-10,10,153100,153600,28022,-86322,-83322,OK
298.984,TraderOne,Tick,1718,1718,0,0,153100,153600,28328,-82628,-82628,OK
299.234,TraderOne,Tick,1718,1718,0,0,153100,153400,28328,-82628,-82628,OK
299.547,TraderOne,Tick,1718,1718,0,0,153100,153400,28328,-82628,-82628,OK
299.734,TraderOne,Tick,1718,1718,0,0,153100,153500,28328,-82628,-82628,OK
300.016,TraderOne,Tick,1718,1718,0,0,153100,153700,28328,-82628,-82628,OK
300.266,TraderOne,Tick,1718,1718,0,0,153100,153700,28328,-82628,-82628,OK
300.531,TraderOne,Tick,1718,1718,0,0,153100,153600,28328,-82628,-82628,OK
300.797,TraderOne,Tick,1718,1718,0,0,153100,153600,28328,-82628,-82628,OK
301.063,TraderOne,Tick,1718,1718,0,0,153100,153600,28328,-82628,-82628,OK
301.266,TraderOne,Tick,1718,1718,0,0,153100,153700,28328,-82628,-82628,OK
301.547,TraderOne,Tick,1718,1718,0,0,153100,153600,28328,-82628,-82628,OK
301.75,TraderOne,Tick,1718,1718,0,0,153100,153600,28328,-82628,-82628,OK
301.984,TraderOne,Tick,1718,1718,0,0,153100,153600,28328,-82628,-82628,OK
302.219,TraderOne,Tick,1718,1718,0,0,153100,153600,28328,-82628,-82628,OK
302.484,TraderOne,Tick,1718,1718,0,0,153100,153600,28328,-82628,-82628,OK
302.797,TraderOne,Tick,1728,1718,10,-10,153300,153600,28174,-83474,-86474,OK
302.969,TraderOne,Tick,1728,1728,0,0,153700,153600,28481,-83781,-83781,OK
303.219,TraderOne,Tick,1738,1738,0,0,153000,153300,28634,-84934,-84934,OK
303.531,TraderOne,Tick,1738,1738,0,0,153000,153400,28634,-84934,-84934,OK
303.797,TraderOne,Tick,1738,1738,0,0,153000,153400,28634,-84934,-84934,OK
304.016,TraderOne,Tick,1738,1738,0,0,153000,153400,28634,-84934,-84934,OK
304.25,TraderOne,Tick,1738,1748,-10,10,154000,153200,28480,-81780,-84780,OK
304.516,TraderOne,Tick,1738,1748,-10,10,154000,153100,28480,-81780,-84780,OK
304.75,TraderOne,Tick,1738,1748,-10,10,154000,153100,28480,-81780,-84780,OK
305.063,TraderOne,Tick,1748,1758,-10,10,152500,152900,28174,-80474,-77474,OK
305.281,TraderOne,Tick,1748,1758,-10,10,152500,152900,28174,-80474,-77474,OK
305.484,TraderOne,Tick,1748,1758,-10,10,152500,152900,28174,-80474,-77474,OK
305.797,TraderOne,Tick,1748,1758,-10,10,152500,152800,28174,-80474,-77474,OK
305.953,TraderOne,Tick,1748,1758,-10,10,152500,152800,28174,-80474,-77474,OK
306.219,TraderOne,Tick,1748,1758,-10,10,152500,152800,28174,-80474,-77474,OK
306.516,TraderOne,Tick,1758,1758,0,0,152500,152600,28021,-82321,-82321,OK
306.797,TraderOne,Tick,1758,1758,0,0,152500,152600,28021,-82321,-82321,OK
306.984,TraderOne,Tick,1758,1758,0,0,152500,152600,28021,-82321,-82321,OK
307.266,TraderOne,Tick,1758,1758,0,0,152500,152900,28021,-82321,-82321,OK
307.516,TraderOne,Tick,1758,1758,0,0,152500,152900,28021,-82321,-82321,OK
307.719,TraderOne,Tick,1758,1758,0,0,152500,152900,28021,-82321,-82321,OK
307.984,TraderOne,Tick,1758,1758,0,0,152500,152900,28021,-82321,-82321,OK
308.25,TraderOne,Tick,1758,1758,0,0,152500,152900,28021,-82321,-82321,OK
308.547,TraderOne,Tick,1758,1758,0,0,152500,152900,28021,-82321,-82321,OK
308.766,TraderOne,Tick,1758,1758,0,0,152500,152900,28021,-82321,-82321,OK
309.063,TraderOne,Tick,1758,1758,0,0,152500,152900,28021,-82321,-82321,OK
309.219,TraderOne,Tick,1768,1758,10,-10,153200,152900,27868,-83168,-80168,OK
309.547,TraderOne,Tick,1778,1768,10,-10,152600,153200,27562,-81862,-84862,OK
309.766,TraderOne,Tick,1778,1768,10,-10,152600,153200,27562,-81862,-84862,OK
310.047,TraderOne,Tick,1778,1768,10,-10,152600,153400,27562,-81862,-84862,OK
310.328,TraderOne,Tick,1778,1775,3,-3,153400,154100,27455,-86655,-87555,OK
310.547,TraderOne,Tick,1788,1775,13,-13,153800,154200,27763,-84963,-88863,OK
310.734,TraderOne,Tick,1798,1775,23,-23,153800,154200,28071,-83271,-90171,OK
310.969,TraderOne,Tick,1808,1785,23,-23,154100,154200,28225,-83425,-85725,OK
311.219,TraderOne,Tick,1808,1785,23,-23,154100,154200,28225,-83425,-85725,OK
311.453,TraderOne,Tick,1808,1795,13,-13,154100,154200,28071,-85271,-86571,OK
311.813,TraderOne,Tick,1808,1795,13,-13,154100,154200,28071,-85271,-86571,OK
311.984,TraderOne,Tick,1808,1795,13,-13,154100,154200,28071,-85271,-86571,OK
312.25,TraderOne,Tick,1808,1795,13,-13,154100,154200,28071,-85271,-86571,OK
312.516,TraderOne,Tick,1808,1795,13,-13,154100,154200,28071,-85271,-86571,OK
312.75,TraderOne,Tick,1818,1795,23,-23,153600,154200,28379,-84579,-91479,OK
312.969,TraderOne,Tick,1818,1795,23,-23,153600,154200,28379,-84579,-91479,OK
313.203,TraderOne,Tick,1818,1795,23,-23,153600,154300,28379,-84579,-91479,OK
313.438,TraderOne,Tick,1818,1805,13,-13,154300,154300,28225,-86425,-86425,OK
313.734,TraderOne,Tick,1818,1805,13,-13,154300,154300,28225,-86425,-86425,OK
313.969,TraderOne,Tick,1818,1805,13,-13,154300,154300,28225,-86425,-86425,OK
314.219,TraderOne,Tick,1818,1805,13,-13,154300,154300,28225,-86425,-86425,OK
314.531,TraderOne,Tick,1818,1805,13,-13,154300,154300,28225,-86425,-86425,OK
314.797,TraderOne,Tick,1818,1815,3,-3,154500,154300,28071,-87271,-86671,OK
315.047,TraderOne,Tick,1818,1815,3,-3,154500,154300,28071,-87271,-86671,OK
315.297,TraderOne,Tick,1818,1815,3,-3,154500,154300,28071,-87271,-86671,OK
315.5,TraderOne,Tick,1818,1815,3,-3,154500,154300,28071,-87271,-86671,OK
315.75,TraderOne,Tick,1818,1815,3,-3,154500,154300,28071,-87271,-86671,OK
315.984,TraderOne,Tick,1818,1815,3,-3,154500,154300,28071,-87271,-86671,OK
316.234,TraderOne,Tick,1818,1815,3,-3,154500,154300,28071,-87271,-86671,OK
316.5,TraderOne,Tick,1818,1815,3,-3,154500,154300,28071,-87271,-86671,OK
316.813,TraderOne,Tick,1818,1815,3,-3,154500,154300,28071,-87271,-86671,OK
316.969,TraderOne,Tick,1828,1815,13,-13,154200,154300,27917,-86117,-87417,OK
317.281,TraderOne,Tick,1828,1825,3,-3,154300,154200,28226,-86426,-86126,OK
317.563,TraderOne,Tick,1828,1835,-7,7,154500,154200,28535,-85735,-87835,OK
317.781,TraderOne,Tick,1828,1845,-17,17,154300,154200,28844,-84044,-85744,OK
318.031,TraderOne,Tick,1828,1855,-27,27,154300,154200,29153,-81353,-84053,OK
318.313,TraderOne,Tick,1828,1855,-27,27,154300,154200,29153,-81353,-84053,OK
318.484,TraderOne,Tick,1828,1865,-37,37,154300,153800,29462,-77662,-88762,OK
318.781,TraderOne,Tick,1828,1875,-47,47,154400,153800,29771,-73971,-88071,OK
319.031,TraderOne,Tick,1828,1875,-47,47,154400,153800,29771,-73971,-88071,OK
319.297,TraderOne,Tick,1828,1875,-47,47,154300,153800,29771,-73971,-88071,OK
319.516,TraderOne,Tick,1828,1875,-47,47,154300,153800,29771,-73971,-88071,OK
319.781,TraderOne,Tick,1828,1875,-47,47,154300,153700,29771,-73971,-88071,OK
320.0,TraderOne,Tick,1828,1885,-57,57,154400,153700,29663,-68863,-85963,OK
320.281,TraderOne,Tick,1828,1885,-57,57,154400,153700,29663,-68863,-85963,OK
320.5,TraderOne,Tick,1828,1885,-57,57,154400,153900,29663,-68863,-85963,OK
320.75,TraderOne,Tick,1838,1885,-47,47,154400,153900,29972,-75172,-89272,OK
321.016,TraderOne,Tick,1838,1885,-47,47,154400,153900,29972,-75172,-89272,OK
321.25,TraderOne,Tick,1838,1885,-47,47,154400,153900,29972,-75172,-89272,OK
321.484,TraderOne,Tick,1838,1888,-50,50,154400,153900,29926,-73626,-88626,OK
321.719,TraderOne,Tick,1848,1888,-40,40,154400,153800,30235,-78935,-90935,OK
321.969,TraderOne,Tick,1848,1898,-50,50,154200,153800,30543,-75243,-90243,OK
322.266,TraderOne,Tick,1848,1898,-50,50,154200,153800,30543,-75243,-90243,OK
322.453,TraderOne,Tick,1848,1898,-50,50,154200,153800,30543,-75243,-90243,OK
322.719,TraderOne,Tick,1848,1898,-50,50,154200,153800,30543,-75243,-90243,OK
322.953,TraderOne,Tick,1848,1898,-50,50,154200,153800,30543,-75243,-90243,OK
323.203,TraderOne,Tick,1848,1898,-50,50,154200,153800,30543,-75243,-90243,OK
323.5,TraderOne,Tick,1848,1908,-60,60,154400,153800,30389,-71089,-89089,OK
323.734,TraderOne,Tick,1858,1908,-50,50,154400,153800,30235,-77935,-92935,OK
324.0,TraderOne,Tick,1858,1908,-50,50,154400,153800,30235,-77935,-92935,OK
324.297,TraderOne,Tick,1858,1908,-50,50,154400,153800,30235,-77935,-92935,OK
324.563,TraderOne,Tick,1868,1908,-40,40,153900,153800,30081,-83781,-87781,OK
324.766,TraderOne,Tick,1868,1908,-40,40,153900,153800,30081,-83781,-87781,OK
324.953,TraderOne,Tick,1868,1908,-40,40,153900,153800,30081,-83781,-87781,OK
325.25,TraderOne,Tick,1868,1908,-40,40,153900,153600,30081,-83781,-95781,OK
325.563,TraderOne,Tick,1868,1908,-40,40,153900,153600,30081,-83781,-95781,OK
325.781,TraderOne,Tick,1868,1908,-40,40,153900,153600,30081,-83781,-95781,OK
326.047,TraderOne,Tick,1878,1908,-30,30,153000,153600,29927,-87627,-78627,OK
326.25,TraderOne,Tick,1878,1908,-30,30,153000,153600,29927,-87627,-78627,OK
326.563,TraderOne,Tick,1878,1908,-30,30,153000,153500,29927,-87627,-78627,OK
326.766,TraderOne,Tick,1878,1908,-30,30,153000,153500,29927,-87627,-78627,OK
327.016,TraderOne,Tick,1878,1908,-30,30,153000,153400,29927,-87627,-78627,OK
327.297,TraderOne,Tick,1878,1908,-30,30,153000,153400,29927,-87627,-78627,OK
327.5,TraderOne,Tick,1878,1917,-39,39,153900,153400,29788,-83888,-95588,OK
327.703,TraderOne,Tick,1878,1918,-40,39,154000,153400,29773,70027,-95373,OK
327.984,TraderOne,Tick,1878,1918,-40,40,154000,153400,29773,-83373,-95373,OK
328.297,TraderOne,Tick,1888,1928,-40,40,152900,153400,29465,-84065,-72065,OK
328.453,TraderOne,Tick,1888,1928,-40,40,152900,153400,29465,-84065,-72065,OK
328.75,TraderOne,Tick,1888,1928,-40,40,152900,153400,29465,-84065,-72065,OK
329.031,TraderOne,Tick,1888,1928,-40,40,152900,153400,29465,-84065,-72065,OK
329.234,TraderOne,Tick,1888,1928,-40,40,152900,153400,29465,-84065,-72065,OK
329.453,TraderOne,Tick,1888,1928,-40,40,152900,153400,29465,-84065,-72065,OK
329.797,TraderOne,Tick,1888,1928,-40,40,152900,153400,29465,-84065,-72065,OK
330.016,TraderOne,Tick,1888,1928,-40,40,152900,153400,29465,-84065,-72065,OK
330.203,TraderOne,Tick,1888,1928,-40,40,152900,153400,29465,-84065,-72065,OK
330.469,TraderOne,Tick,1888,1928,-40,40,152900,153500,29465,-84065,-72065,OK
330.703,TraderOne,Tick,1888,1938,-50,50,154000,153500,29311,-80911,-95911,OK
330.953,TraderOne,Tick,1888,1938,-50,50,154000,153500,29311,-80911,-95911,OK
331.25,TraderOne,Tick,1888,1938,-50,50,154000,153400,29311,-80911,-95911,OK
331.469,TraderOne,Tick,1888,1938,-50,50,154000,153400,29311,-80911,-95911,OK
331.75,TraderOne,Tick,1898,1938,-40,40,152900,153400,29157,-85757,-73757,OK
332.0,TraderOne,Tick,1898,1938,-40,40,152900,153400,29157,-85757,-73757,OK
332.25,TraderOne,Tick,1898,1938,-40,40,152900,153400,29157,-85757,-73757,OK
332.469,TraderOne,Tick,1898,1948,-50,50,154000,153400,29003,-80603,-95603,OK
332.719,TraderOne,Tick,1898,1948,-50,50,154000,153400,29003,-80603,-95603,OK
333.031,TraderOne,Tick,1898,1948,-50,50,154000,153400,29003,-80603,-95603,OK
333.266,TraderOne,Tick,1898,1948,-50,50,154000,153400,29003,-80603,-95603,OK
333.484,TraderOne,Tick,1898,1948,-50,50,154000,153400,29003,-80603,-95603,OK
333.766,TraderOne,Tick,1898,1948,-50,50,154000,153400,29003,-80603,-95603,OK
334.047,TraderOne,Tick,1898,1948,-50,50,154000,153200,29003,-80603,-95603,OK
334.297,TraderOne,Tick,1898,1948,-50,50,154000,153200,29003,-80603,-95603,OK
334.484,TraderOne,Tick,1898,1948,-50,50,154000,153200,29003,-80603,-95603,OK
334.797,TraderOne,Tick,1898,1948,-50,50,154000,153200,29003,-80603,-95603,OK
335.047,TraderOne,Tick,1898,1948,-50,50,154000,153200,29003,-80603,-95603,OK
335.266,TraderOne,Tick,1898,1948,-50,50,154000,153200,29003,-80603,-95603,OK
335.484,TraderOne,Tick,1898,1958,-60,60,154000,153200,28849,-75449,-93449,OK
335.75,TraderOne,Tick,1908,1958,-50,50,152800,153200,28695,-82295,-67295,OK
336.016,TraderOne,Tick,1908,1958,-50,50,152800,153200,28695,-82295,-67295,OK
336.25,TraderOne,Tick,1908,1958,-50,50,152800,153200,28695,-82295,-67295,OK
336.547,TraderOne,Tick,1908,1968,-60,60,153800,153300,28541,-77141,-95141,OK
336.813,TraderOne,Tick,1908,1968,-60,60,153800,153300,28541,-77141,-95141,OK
337.031,TraderOne,Tick,1908,1968,-60,60,153800,153300,28541,-77141,-95141,OK
337.219,TraderOne,Tick,1908,1968,-60,60,153800,153300,28541,-77141,-95141,OK
337.531,TraderOne,Tick,1918,1968,-50,50,154000,153300,28387,-82987,-97987,OK
337.75,TraderOne,Tick,1918,1968,-50,50,154000,153300,28387,-82987,-97987,OK
338.0,TraderOne,Tick,1918,1968,-50,50,154000,153300,28387,-82987,-97987,OK
338.25,TraderOne,Tick,1918,1968,-50,50,154000,153300,28387,-82987,-97987,OK
338.484,TraderOne,Tick,1918,1968,-50,50,154000,153300,28387,-82987,-97987,OK
338.766,TraderOne,Tick,1918,1968,-50,50,154000,153300,28387,-82987,-97987,OK
339.0,TraderOne,Tick,1918,1968,-50,50,154000,153300,28387,-82987,-97987,OK
339.234,TraderOne,Tick,1918,1978,-60,60,154000,153300,28233,-77833,-95833,OK
339.5,TraderOne,Tick,1928,1978,-50,50,154000,153500,28541,-84141,-99141,OK
339.781,TraderOne,Tick,1938,1978,-40,40,153800,153500,28849,-88449,-100449,OK
339.969,TraderOne,Tick,1947,1978,-31,31,153800,153500,29126,-92326,-101626,OK
340.281,TraderOne,Tick,1947,1978,-31,31,153800,153500,29126,-92326,-101626,OK
340.453,TraderOne,Tick,1947,1978,-31,31,153800,153500,29126,-92326,-101626,OK
340.766,TraderOne,Tick,1947,1978,-31,31,153800,153300,29126,-92326,-101626,OK
341.016,TraderOne,Tick,1947,1978,-31,31,153800,153300,29126,-92326,-101626,OK
341.266,TraderOne,Tick,1947,1978,-31,31,153800,153300,29126,-92326,-101626,OK
341.563,TraderOne,Tick,1947,1978,-31,31,153800,153300,29126,-92326,-101626,OK
341.813,TraderOne,Tick,1947,1988,-41,41,154100,153300,28972,-89172,-101472,OK
341.969,TraderOne,Tick,1947,1988,-41,41,154100,153300,28972,-89172,-101472,OK
342.297,TraderOne,Tick,1947,1988,-41,41,154100,153300,28972,-89172,-101472,OK
342.516,TraderOne,Tick,1957,1988,-31,41,154000,153300,28818,-1629018,-105318,OK
342.781,TraderOne,Tick,1957,1988,-31,31,154000,153300,28818,-95018,-104318,OK
343.0,TraderOne,Tick,1957,1988,-31,31,154000,153300,28818,-95018,-104318,OK
343.203,TraderOne,Tick,1957,1988,-31,31,154000,153300,28818,-95018,-104318,OK
343.484,TraderOne,Tick,1957,1998,-41,41,153800,153300,29126,-90326,-102626,OK
343.734,TraderOne,Tick,1957,2002,-45,45,153700,153300,29249,-88049,-101549,OK
343.953,TraderOne,Tick,1967,2002,-35,35,152800,153300,29095,-91895,-81395,OK
344.297,TraderOne,Tick,1967,2002,-35,35,152800,153000,29095,-91895,-84895,OK
344.547,TraderOne,Tick,1967,2002,-35,35,152800,153000,29095,-91895,-84895,OK
344.781,TraderOne,Tick,1977,2002,-25,25,152500,152900,28942,-95742,-88242,OK
345.031,TraderOne,Tick,1977,2002,-25,25,152500,152900,28942,-95742,-88242,OK
345.313,TraderOne,Tick,1977,2002,-25,25,152500,152900,28942,-95742,-88242,OK
345.531,TraderOne,Tick,1977,2002,-25,25,152500,152900,28942,-95742,-88242,OK
345.781,TraderOne,Tick,1977,2002,-25,25,152500,152700,28942,-95742,-90742,OK
345.953,TraderOne,Tick,1977,2005,-28,28,153100,152700,28896,-94496,-102896,OK
346.266,TraderOne,Tick,1977,2005,-28,28,153100,152700,28896,-94496,-102896,OK
346.484,TraderOne,Tick,1977,2005,-28,28,153100,152600,28896,-94496,-102896,OK
346.766,TraderOne,Tick,1977,2005,-28,28,153100,152800,28896,-94496,-102896,OK
347.031,TraderOne,Tick,1977,2005,-28,28,153100,152700,28896,-94496,-102896,OK
347.297,TraderOne,Tick,1977,2005,-28,28,153100,152700,28896,-94496,-102896,OK
347.563,TraderOne,Tick,1977,2005,-28,28,153100,152700,28896,-94496,-102896,OK
347.703,TraderOne,Tick,1987,2005,-18,18,152500,152700,28743,-97343,-93743,OK
348.047,TraderOne,Tick,1997,2005,-8,8,152800,152700,29049,-99649,-100449,OK
348.234,TraderOne,Tick,2007,2005,2,-2,152000,152700,28896,-99496,-100096,OK
348.484,TraderOne,Tick,2007,2005,2,-2,152000,152700,28896,-99496,-100096,OK
348.766,TraderOne,Tick,2007,2005,2,-2,152000,152600,28896,-99496,-100096,OK
349.047,TraderOne,Tick,2007,2005,2,-2,152000,152600,28896,-99496,-100096,OK
349.297,TraderOne,Tick,2007,2005,2,-2,152000,152600,28896,-99496,-100096,OK
349.5,TraderOne,Tick,2007,2005,2,-2,152000,152600,28896,-99496,-100096,OK
349.781,TraderOne,Tick,2007,2005,2,-2,152000,152600,28896,-99496,-100096,OK
350.016,TraderOne,Tick,2007,2005,2,-2,152000,152600,28896,-99496,-100096,OK
350.25,TraderOne,Tick,2007,2005,2,-2,152000,152600,28896,-99496,-100096,OK
350.469,TraderOne,Tick,2007,2005,2,-2,152000,152600,28896,-99496,-100096,OK
350.719,TraderOne,Tick,2007,2005,2,-2,152000,152600,28896,-99496,-100096,OK
351.047,TraderOne,Tick,2007,2005,2,-2,152000,152600,28896,-99496,-100096,OK
351.219,TraderOne,Tick,2007,2005,2,-2,152000,152600,28896,-99496,-100096,OK
351.5,TraderOne,Tick,2007,2005,2,-2,152000,152500,28896,-99496,-100096,OK
351.781,TraderOne,Tick,2007,2015,-8,8,152700,152500,28744,-99344,-100944,OK
352.031,TraderOne,Tick,2007,2025,-18,18,152700,152300,29049,-97649,-103049,OK
352.219,TraderOne,Tick,2007,2035,-28,28,152700,152300,29354,-94954,-103354,OK
352.5,TraderOne,Tick,2007,2035,-28,28,152700,152300,29354,-94954,-103354,OK
352.797,TraderOne,Tick,2007,2035,-28,28,152700,152300,29354,-94954,-103354,OK
353.031,TraderOne,Tick,2007,2045,-38,38,152700,152300,29659,-91259,-102659,OK
353.297,TraderOne,Tick,2012,2055,-43,43,152500,152300,29888,-89488,-98088,OK
353.484,TraderOne,Tick,2012,2055,-43,43,152500,152100,29888,-89488,-102388,OK
353.719,TraderOne,Tick,2012,2055,-43,43,152500,152100,29888,-89488,-102388,OK
354.016,TraderOne,Tick,2012,2055,-43,43,152500,152100,29888,-89488,-102388,OK
354.25,TraderOne,Tick,2012,2055,-43,43,152500,152100,29888,-89488,-102388,OK
354.547,TraderOne,Tick,2012,2055,-43,43,152500,152100,29888,-89488,-102388,OK
354.75,TraderOne,Tick,2012,2055,-43,43,152500,152100,29888,-89488,-102388,OK
354.984,TraderOne,Tick,2022,2055,-33,33,152800,152100,30194,-93794,-103694,OK
355.313,TraderOne,Tick,2023,2055,-32,32,152800,152100,30225,-94225,-103825,OK
355.547,TraderOne,Tick,2023,2055,-32,32,153000,152500,30225,-94225,-103825,OK
355.766,TraderOne,Tick,2023,2055,-32,32,153000,152500,30225,-94225,-103825,OK
356.031,TraderOne,Tick,2023,2055,-32,32,153000,152500,30225,-94225,-103825,OK
356.281,TraderOne,Tick,2023,2055,-32,32,153000,152500,30225,-94225,-103825,OK
356.484,TraderOne,Tick,2023,2055,-32,32,153000,152400,30225,-94225,-103825,OK
356.703,TraderOne,Tick,2023,2055,-32,32,153000,152400,30225,-94225,-103825,OK
356.969,TraderOne,Tick,2023,2055,-32,32,153000,152400,30225,-94225,-103825,OK
357.266,TraderOne,Tick,2023,2055,-32,32,153000,152400,30225,-94225,-103825,OK
357.531,TraderOne,Tick,2023,2065,-42,42,153000,152400,30072,-91072,-103672,OK
357.75,TraderOne,Tick,2023,2065,-42,42,153000,152400,30072,-91072,-103672,OK
358.0,TraderOne,Tick,2023,2065,-42,42,153000,152400,30072,-91072,-103672,OK
358.25,TraderOne,Tick,2033,2065,-32,32,152800,152400,29919,-95919,-105519,OK
358.547,TraderOne,Tick,2043,2065,-22,22,152600,152100,30224,-99224,-105824,OK
358.797,TraderOne,Tick,2043,2075,-32,22,152800,152100,30072,1425928,-104672,OK
359.031,TraderOne,Tick,2043,2075,-32,32,152800,152100,30072,-96072,-105672,OK
359.219,TraderOne,Tick,2043,2075,-32,32,152800,152100,30072,-96072,-105672,OK
359.547,TraderOne,Tick,2043,2075,-32,32,152800,152100,30072,-96072,-105672,OK
359.828,TraderOne,Tick,2043,2075,-32,32,152800,151400,30072,-96072,-105672,OK
360.016,TraderOne,Tick,2043,2085,-42,42,152100,151400,30377,-89377,-101977,OK
360.234,TraderOne,Tick,2053,2085,-32,32,152000,151400,30681,-94681,-104281,OK
360.516,TraderOne,Tick,2053,2085,-32,32,152000,151800,30681,-94681,-101081,OK
360.75,TraderOne,Tick,2053,2095,-42,42,152400,152000,30529,-90529,-103129,OK
361.016,TraderOne,Tick,2063,2095,-32,32,152400,152300,30834,-94834,-98034,OK
361.234,TraderOne,Tick,2063,2095,-32,32,152400,152300,30834,-94834,-98034,OK
361.5,TraderOne,Tick,2063,2095,-32,32,152400,152300,30834,-94834,-98034,OK
361.75,TraderOne,Tick,2063,2095,-32,32,152400,152300,30834,-94834,-98034,OK
361.953,TraderOne,Tick,2063,2095,-32,32,152400,152300,30834,-94834,-98034,OK
362.203,TraderOne,Tick,2073,2105,-32,42,151900,152300,30530,-1611530,-78930,OK
362.516,TraderOne,Tick,2073,2115,-42,42,152500,152300,30378,-89378,-97778,OK
362.813,TraderOne,Tick,2073,2115,-42,42,152500,152100,30378,-89378,-101978,OK
362.953,TraderOne,Tick,2083,2115,-32,32,152500,152100,30226,-96226,-105826,OK
363.25,TraderOne,Tick,2083,2115,-32,32,152500,152100,30226,-96226,-105826,OK
363.469,TraderOne,Tick,2083,2115,-32,32,152500,152100,30226,-96226,-105826,OK
363.719,TraderOne,Tick,2083,2115,-32,32,152500,152100,30226,-96226,-105826,OK
363.984,TraderOne,Tick,2083,2115,-32,32,152500,152100,30226,-96226,-105826,OK
364.297,TraderOne,Tick,2083,2125,-42,42,152200,152100,30074,-92074,-96274,OK
364.453,TraderOne,Tick,2083,2125,-42,42,152200,152100,30074,-92074,-96274,OK
364.703,TraderOne,Tick,2093,2125,-32,42,151900,152100,29922,-1611922,-84522,OK
364.953,TraderOne,Tick,2093,2135,-42,42,151800,152100,30226,-94226,-81626,OK
365.234,TraderOne,Tick,2093,2135,-42,42,151800,152100,30226,-94226,-81626,OK
365.469,TraderOne,Tick,2093,2135,-42,42,151800,152100,30226,-94226,-81626,OK
365.797,TraderOne,Tick,2093,2145,-52,52,152200,152100,30074,-89074,-94274,OK
366.016,TraderOne,Tick,2103,2145,-42,42,152000,152100,29922,-95922,-91722,OK
366.25,TraderOne,Tick,2103,2145,-42,42,151800,152100,29922,-95922,-83322,OK
366.484,TraderOne,Tick,2103,2155,-52,52,152000,151500,29770,-91770,-107370,OK
366.781,TraderOne,Tick,2113,2155,-42,42,152000,151500,30074,-97074,-109674,OK
367.0,TraderOne,Tick,2113,2155,-42,42,152000,151500,30074,-97074,-109674,OK
367.266,TraderOne,Tick,2123,2165,-42,42,152100,151500,29770,-97770,-110370,OK
367.531,TraderOne,Tick,2123,2165,-42,42,152100,151600,29770,-97770,-110370,OK
367.75,TraderOne,Tick,2123,2165,-42,42,152100,151800,29770,-97770,-110370,OK
368.0,TraderOne,Tick,2123,2165,-42,42,152100,151800,29770,-97770,-110370,OK
368.234,TraderOne,Tick,2123,2165,-42,42,152100,151800,29770,-97770,-110370,OK
368.516,TraderOne,Tick,2123,2165,-42,42,152100,151800,29770,-97770,-110370,OK
368.75,TraderOne,Tick,2123,2165,-42,42,152100,151800,29770,-97770,-110370,OK
369.0,TraderOne,Tick,2123,2165,-42,42,152100,151700,29770,-97770,-110370,OK
369.281,TraderOne,Tick,2123,2165,-42,42,152100,151700,29770,-97770,-110370,OK
369.547,TraderOne,Tick,2123,2165,-42,42,152100,151700,29770,-97770,-110370,OK
369.719,TraderOne,Tick,2123,2165,-42,42,152100,151700,29770,-97770,-110370,OK
370.047,TraderOne,Tick,2123,2165,-42,42,152100,152000,29770,-97770,-101970,OK
370.219,TraderOne,Tick,2133,2165,-32,32,152400,152000,30075,-102075,-111675,OK
370.516,TraderOne,Tick,2143,2165,-22,22,152400,152000,30380,-106380,-112980,OK
370.781,TraderOne,Tick,2143,2165,-22,22,152400,152000,30380,-106380,-112980,OK
370.953,TraderOne,Tick,2153,2165,-12,12,152400,152000,30685,-109685,-113285,OK
371.25,TraderOne,Tick,2153,2165,-12,12,152400,152000,30685,-109685,-113285,OK
371.484,TraderOne,Tick,2153,2165,-12,12,152400,152000,30685,-109685,-113285,OK
371.75,TraderOne,Tick,2153,2165,-12,12,152400,152000,30685,-109685,-113285,OK
372.016,TraderOne,Tick,2153,2165,-12,12,152400,152000,30685,-109685,-113285,OK
372.281,TraderOne,Tick,2173,2165,8,-8,151900,152000,30837,-108837,-109637,OK
372.469,TraderOne,Tick,2183,2165,18,-18,151900,152000,31141,-108141,-109941,OK
372.813,TraderOne,Tick,2193,2165,28,-28,151900,152000,31445,-107445,-110245,OK
372.953,TraderOne,Tick,2193,2165,28,-28,151900,152000,31445,-107445,-110245,OK
373.266,TraderOne,Tick,2193,2175,18,-28,152000,152000,31293,1412707,-107293,OK
373.5,TraderOne,Tick,2193,2183,10,-10,152300,152000,31537,-105137,-102137,OK
373.828,TraderOne,Tick,2193,2183,10,-10,152300,152000,31537,-105137,-102137,OK
374.016,TraderOne,Tick,2193,2183,10,-10,152300,152000,31537,-105137,-102137,OK
374.281,TraderOne,Tick,2193,2183,10,-10,152300,152000,31537,-105137,-102137,OK
374.5,TraderOne,Tick,2193,2183,10,-10,152300,152000,31537,-105137,-102137,OK
374.813,TraderOne,Tick,2193,2183,10,-10,152300,152000,31537,-105137,-102137,OK
374.969,TraderOne,Tick,2193,2183,10,-10,152300,152000,31537,-105137,-102137,OK
375.281,TraderOne,Tick,2193,2193,0,-10,152400,152000,31385,1418015,-101985,OK
375.469,TraderOne,Tick,2193,2193,0,0,152400,152000,31385,-104985,-104985,OK
375.766,TraderOne,Tick,2193,2193,0,0,152400,152000,31385,-104985,-104985,OK
376.016,TraderOne,Tick,2193,2193,0,0,152400,152000,31385,-104985,-104985,OK
376.266,TraderOne,Tick,2193,2193,0,0,152400,152000,31385,-104985,-104985,OK
376.453,TraderOne,Tick,2193,2193,0,0,152400,152000,31385,-104985,-104985,OK
376.797,TraderOne,Tick,2193,2193,0,0,152400,152000,31385,-104985,-104985,OK
377.047,TraderOne,Tick,2203,2193,10,-10,151900,152000,31233,-105833,-106833,OK
377.281,TraderOne,Tick,2203,2193,10,-10,151900,152000,31233,-105833,-106833,OK
377.469,TraderOne,Tick,2203,2193,10,-10,151900,152300,31233,-105833,-108833,OK
377.766,TraderOne,Tick,2203,2193,10,-10,151900,152300,31233,-105833,-108833,OK
378.047,TraderOne,Tick,2203,2193,10,-10,151900,152300,31233,-105833,-108833,OK
378.281,TraderOne,Tick,2203,2203,0,0,152800,152300,31081,-106681,-106681,OK
378.563,TraderOne,Tick,2213,2203,10,-10,151800,152300,30929,-106529,-109529,OK
378.766,TraderOne,Tick,2213,2213,0,0,152200,152300,30777,-107377,-107377,OK
379.031,TraderOne,Tick,2223,2223,0,0,151800,152300,30930,-103530,-103530,OK
379.25,TraderOne,Tick,2223,2223,0,0,151800,152300,30930,-103530,-103530,OK
379.516,TraderOne,Tick,2223,2223,0,0,151800,152300,30930,-103530,-103530,OK
379.734,TraderOne,Tick,2223,2223,0,0,151800,152300,30930,-103530,-103530,OK
379.969,TraderOne,Tick,2223,2223,0,0,151800,152300,30930,-103530,-103530,OK
380.281,TraderOne,Tick,2231,2223,8,-8,152100,152300,30808,-103408,-105008,OK
380.547,TraderOne,Tick,2231,2223,8,-8,152100,152300,30808,-103408,-105008,OK
380.766,TraderOne,Tick,2241,2223,18,-18,151800,152300,30656,-103256,-108656,OK
380.984,TraderOne,Tick,2241,2223,18,-18,151800,152300,30656,-103256,-108656,OK
381.25,TraderOne,Tick,2241,2223,18,-18,151800,152300,30656,-103256,-108656,OK
381.531,TraderOne,Tick,2241,2223,18,-18,151800,152300,30656,-103256,-108656,OK
381.75,TraderOne,Tick,2241,2233,8,-8,152900,152300,30504,-104104,-101704,OK
382.031,TraderOne,Tick,2248,2233,15,-15,152400,152500,30397,-103997,-105497,OK
382.25,TraderOne,Tick,2248,2233,15,-15,152400,152500,30397,-103997,-105497,OK
382.453,TraderOne,Tick,2248,2233,15,-15,152400,152500,30397,-103997,-105497,OK
382.797,TraderOne,Tick,2248,2233,15,-15,152400,152500,30397,-103997,-105497,OK
382.969,TraderOne,Tick,2248,2233,15,-15,152400,152500,30397,-103997,-105497,OK
383.266,TraderOne,Tick,2248,2233,15,-15,152400,152500,30397,-103997,-105497,OK
383.484,TraderOne,Tick,2248,2243,5,-5,152900,152500,30245,-105845,-104345,OK
383.766,TraderOne,Tick,2248,2253,-5,5,152900,152500,30551,-103151,-104651,OK
384.031,TraderOne,Tick,2248,2260,-12,12,152900,152500,30765,-101265,-104865,OK
384.297,TraderOne,Tick,2248,2260,-12,12,152900,152500,30765,-101265,-104865,OK
384.5,TraderOne,Tick,2248,2260,-12,12,152900,152500,30765,-101265,-104865,OK
384.781,TraderOne,Tick,2248,2260,-12,12,152900,152500,30765,-101265,-104865,OK
385.0,TraderOne,Tick,2248,2260,-12,12,152900,152500,30765,-101265,-104865,OK
385.281,TraderOne,Tick,2248,2260,-12,12,152900,152500,30765,-101265,-104865,OK
385.484,TraderOne,Tick,2258,2260,-2,2,152200,152500,30612,-103112,-102512,OK
385.766,TraderOne,Tick,2258,2260,-2,2,152200,152500,30612,-103112,-102512,OK
386.0,TraderOne,Tick,2258,2260,-2,2,152200,152500,30612,-103112,-102512,OK
386.203,TraderOne,Tick,2258,2260,-2,2,152200,152500,30612,-103112,-102512,OK
386.453,TraderOne,Tick,2268,2260,8,-8,151800,152500,30460,-104960,-107360,OK
386.813,TraderOne,Tick,2268,2260,8,-8,151800,152500,30460,-104960,-107360,OK
386.953,TraderOne,Tick,2268,2260,8,-8,151800,152500,30460,-104960,-107360,OK
387.266,TraderOne,Tick,2268,2260,8,-8,151800,152300,30460,-104960,-107360,OK
387.547,TraderOne,Tick,2268,2270,-2,2,152900,152300,30308,-103808,-104408,OK
387.813,TraderOne,Tick,2268,2270,-2,2,152900,152300,30308,-103808,-104408,OK
387.984,TraderOne,Tick,2268,2270,-2,2,152900,152300,30308,-103808,-104408,OK
388.281,TraderOne,Tick,2268,2270,-2,2,152900,152300,30308,-103808,-104408,OK
388.5,TraderOne,Tick,2278,2270,8,-8,151700,152200,30156,-103656,-106056,OK
388.75,TraderOne,Tick,2278,2270,8,-8,151700,152200,30156,-103656,-106056,OK
389.031,TraderOne,Tick,2278,2270,8,-8,151700,152200,30156,-103656,-106056,OK
389.281,TraderOne,Tick,2278,2280,-2,2,152900,152400,30004,-104504,-105104,OK
389.547,TraderOne,Tick,2278,2280,-2,2,152900,152400,30004,-104504,-105104,OK
389.703,TraderOne,Tick,2278,2280,-2,2,152900,152400,30004,-104504,-105104,OK
389.969,TraderOne,Tick,2278,2280,-2,2,152900,152200,30004,-104504,-105104,OK
390.297,TraderOne,Tick,2278,2280,-2,2,152900,152200,30004,-104504,-105104,OK
390.5,TraderOne,Tick,2278,2280,-2,2,152900,152200,30004,-104504,-105104,OK
390.766,TraderOne,Tick,2278,2280,-2,2,152900,152100,30004,-104504,-105104,OK
391.0,TraderOne,Tick,2278,2280,-2,2,152900,152100,30004,-104504,-105104,OK
391.297,TraderOne,Tick,2278,2280,-2,2,152900,152100,30004,-104504,-105104,OK
391.547,TraderOne,Tick,2278,2280,-2,2,152900,152100,30004,-104504,-105104,OK
391.813,TraderOne,Tick,2278,2280,-2,2,152900,152100,30004,-104504,-105104,OK
392.0,TraderOne,Tick,2278,2280,-2,2,152900,152100,30004,-104504,-105104,OK
392.25,TraderOne,Tick,2278,2280,-2,2,152900,152100,30004,-104504,-105104,OK
392.484,TraderOne,Tick,2278,2280,-2,2,152900,152100,30004,-104504,-105104,OK
392.703,TraderOne,Tick,2278,2280,-2,2,152900,152100,30004,-104504,-105104,OK
393.0,TraderOne,Tick,2278,2290,-12,12,152400,152100,29852,-103352,-106952,OK
393.266,TraderOne,Tick,2278,2300,-22,22,152700,152200,30157,-99657,-106257,OK
393.484,TraderOne,Tick,2278,2310,-32,32,152700,152200,30462,-97962,-107562,OK
393.75,TraderOne,Tick,2288,2310,-22,22,152800,152500,30768,-102268,-108868,OK
393.953,TraderOne,Tick,2288,2310,-22,22,152800,152500,30768,-102268,-108868,OK
394.234,TraderOne,Tick,2288,2310,-22,22,152800,152400,30768,-102268,-108868,OK
394.547,TraderOne,Tick,2288,2320,-32,32,152700,152400,31073,-99573,-109173,OK
394.766,TraderOne,Tick,2288,2320,-32,32,152700,152400,31073,-99573,-109173,OK
395.016,TraderOne,Tick,2298,2330,-32,22,152900,152400,30767,1424733,-108867,OK
395.313,TraderOne,Tick,2298,2330,-32,32,152900,152400,30767,-99267,-108867,OK
395.547,TraderOne,Tick,2298,2330,-32,32,152900,152400,30767,-99267,-108867,OK
395.797,TraderOne,Tick,2308,2330,-22,22,152600,152300,30614,-103114,-109714,OK
395.969,TraderOne,Tick,2318,2330,-12,12,151900,152300,30918,-100418,-96818,OK
396.234,TraderOne,Tick,2318,2330,-12,12,151900,152300,30918,-100418,-96818,OK
396.484,TraderOne,Tick,2318,2330,-12,12,151900,152300,30918,-100418,-96818,OK
396.719,TraderOne,Tick,2318,2330,-12,12,151900,152300,30918,-100418,-96818,OK
397.047,TraderOne,Tick,2318,2330,-12,12,151900,151700,30918,-100418,-102818,OK
397.219,TraderOne,Tick,2318,2330,-12,12,151900,151400,30918,-100418,-104018,OK
397.484,TraderOne,Tick,2318,2340,-22,22,151900,151400,31222,-95722,-102322,OK
397.766,TraderOne,Tick,2318,2350,-32,32,151800,151400,31526,-92026,-101626,OK
397.984,TraderOne,Tick,2318,2350,-32,32,151800,151400,31526,-92026,-101626,OK
398.281,TraderOne,Tick,2318,2360,-42,42,151600,151400,31829,-88329,-96729,OK
398.531,TraderOne,Tick,2328,2360,-32,32,151600,151100,31677,-94177,-103777,OK
398.781,TraderOne,Tick,2328,2360,-32,32,151600,151100,31677,-94177,-103777,OK
399.047,TraderOne,Tick,2328,2360,-32,32,151600,151200,31677,-94177,-103777,OK
399.266,TraderOne,Tick,2328,2360,-32,32,151600,151200,31677,-94177,-103777,OK
399.5,TraderOne,Tick,2328,2360,-32,32,151600,151200,31677,-94177,-103777,OK
399.734,TraderOne,Tick,2328,2360,-32,32,151400,151200,31677,-94177,-100577,OK
399.969,TraderOne,Tick,2328,2360,-32,32,151400,151200,31677,-94177,-100577,OK
400.203,TraderOne,Tick,2328,2360,-32,32,151400,151200,31677,-94177,-100577,OK
400.563,TraderOne,Tick,2328,2360,-32,32,151400,151200,31677,-94177,-100577,OK
400.797,TraderOne,Tick,2328,2360,-32,32,151400,151000,31677,-94177,-103777,OK
400.969,TraderOne,Tick,2328,2360,-32,32,151400,151000,31677,-94177,-103777,OK
401.219,TraderOne,Tick,2328,2360,-32,32,151300,151000,31677,-94177,-103777,OK
401.531,TraderOne,Tick,2328,2360,-32,32,151300,151000,31677,-94177,-103777,OK
401.75,TraderOne,Tick,2328,2360,-32,32,151300,151000,31677,-94177,-103777,OK
402.063,TraderOne,Tick,2328,2360,-32,32,151300,151000,31677,-94177,-103777,OK
402.266,TraderOne,Tick,2328,2360,-32,32,151300,150900,31677,-94177,-103777,OK
402.453,TraderOne,Tick,2328,2370,-42,42,151400,150900,31980,-90480,-103080,OK
402.703,TraderOne,Tick,2328,2370,-42,42,151400,150900,31980,-90480,-103080,OK
402.984,TraderOne,Tick,2328,2370,-42,42,151400,150900,31980,-90480,-103080,OK
403.25,TraderOne,Tick,2328,2380,-52,52,151400,150900,31829,-85329,-100929,OK
403.516,TraderOne,Tick,2328,2380,-52,52,151400,150900,31829,-85329,-100929,OK
403.781,TraderOne,Tick,2328,2380,-52,52,151400,150900,31829,-85329,-100929,OK
